homeTeam,homeFirstQuater,homeSecondQuater,homeThirdQuater,homeFourthQuater,homeOTQuater,homeTotalScore,awayTeam,awayFirstQuater,awaySecondQuater,awayThirdQuater,awayFourthQuater,awayOTQuater,awayTotalScore,date,preseason,postseason
Jaguars,6,3,0,9,0,18,Panthers,0,6,10,0,0,16,1:2001:True:False,True,False
Lions,7,10,7,0,0,24,Bengals,0,10,7,10,0,27,1:2001:True:False,True,False
Patriots,3,3,3,5,0,14,Giants,0,0,0,0,0,0,1:2001:True:False,True,False
Colts,3,8,14,3,0,28,Seahawks,7,7,7,0,0,21,1:2001:True:False,True,False
Titans,7,6,7,7,0,27,Bears,7,3,0,14,0,24,1:2001:True:False,True,False
Saints,7,0,7,7,0,21,Vikings,7,14,0,7,0,28,1:2001:True:False,True,False
Browns,0,7,3,0,0,10,Packers,0,3,0,0,0,3,1:2001:True:False,True,False
Jets,0,7,3,0,0,10,Falcons,0,10,7,3,0,20,1:2001:True:False,True,False
Cowboys,0,0,3,3,0,6,Broncos,6,7,0,7,0,20,1:2001:True:False,True,False
Cardinals,0,0,0,7,0,7,Raiders,3,7,0,0,0,10,1:2001:True:False,True,False
Chargers,14,0,0,11,0,25,49ers,7,7,0,10,0,24,1:2001:True:False,True,False
Bills,0,7,3,0,0,10,Rams,0,7,0,17,0,24,1:2001:True:False,True,False
Chiefs,10,10,0,0,0,20,Redskins,0,0,0,0,0,0,1:2001:True:False,True,False
Buccaneers,0,7,0,7,0,14,Dolphins,10,0,0,7,0,17,1:2001:True:False,True,False
Vikings,0,17,0,7,0,24,Steelers,7,0,3,0,0,10,2:2001:True:False,True,False
Giants,10,10,0,7,0,27,Jaguars,0,0,0,5,0,5,2:2001:True:False,True,False
Rams,7,0,3,0,0,10,Titans,7,6,7,3,0,23,2:2001:True:False,True,False
Redskins,0,6,0,0,0,6,Falcons,17,7,0,3,0,27,2:2001:True:False,True,False
Dolphins,7,10,0,3,0,20,Chargers,10,0,7,3,3,23,2:2001:True:False,True,False
Colts,14,0,9,3,0,26,Lions,0,17,0,10,0,27,2:2001:True:False,True,False
Panthers,0,0,8,0,0,8,Patriots,3,7,6,7,0,23,2:2001:True:False,True,False
Bills,0,6,0,0,0,6,Eagles,0,0,0,3,0,3,2:2001:True:False,True,False
Jets,3,3,3,7,0,16,Ravens,0,3,0,0,0,3,2:2001:True:False,True,False
Browns,0,7,0,0,0,7,Buccaneers,3,3,0,0,0,6,2:2001:True:False,True,False
Saints,7,3,3,3,0,16,Cowboys,0,3,0,7,0,10,2:2001:True:False,True,False
Chiefs,0,7,3,0,0,10,Bears,0,3,3,3,0,9,2:2001:True:False,True,False
Seahawks,0,13,0,0,0,13,Cardinals,7,0,3,3,3,16,2:2001:True:False,True,False
49ers,7,6,0,7,0,20,Raiders,0,14,3,0,0,17,2:2001:True:False,True,False
Packers,3,0,16,3,0,22,Broncos,0,7,0,0,0,7,2:2001:True:False,True,False
Ravens,3,14,0,0,0,17,Panthers,0,10,7,3,0,20,3:2001:True:False,True,False
Jaguars,7,0,14,7,0,28,Chiefs,3,17,3,0,0,23,3:2001:True:False,True,False
Titans,7,0,0,7,0,14,Eagles,0,17,3,0,0,20,3:2001:True:False,True,False
Redskins,0,7,7,13,0,27,Browns,7,7,0,11,0,25,3:2001:True:False,True,False
Vikings,0,14,7,7,0,28,Colts,10,0,8,3,0,21,3:2001:True:False,True,False
Steelers,7,3,3,7,0,20,Lions,0,0,0,7,0,7,3:2001:True:False,True,False
Buccaneers,0,7,6,7,0,20,Patriots,0,3,0,0,0,3,3:2001:True:False,True,False
Bengals,3,7,0,0,0,10,Bills,2,10,0,8,0,20,3:2001:True:False,True,False
Giants,0,0,7,7,0,14,Jets,7,7,0,3,0,17,3:2001:True:False,True,False
Packers,10,0,0,7,0,17,Dolphins,0,6,6,0,0,12,3:2001:True:False,True,False
Bears,0,0,17,3,0,20,Cardinals,0,14,0,10,0,24,3:2001:True:False,True,False
49ers,0,7,3,8,0,18,Seahawks,21,0,0,7,0,28,3:2001:True:False,True,False
Broncos,7,10,7,7,0,31,Saints,7,0,14,3,0,24,3:2001:True:False,True,False
Chargers,0,3,0,7,3,13,Rams,0,7,3,0,0,10,3:2001:True:False,True,False
Cowboys,0,14,7,0,0,21,Raiders,3,0,0,3,0,6,3:2001:True:False,True,False
Eagles,3,3,0,7,0,13,Jets,3,3,0,6,0,12,4:2001:True:False,True,False
Lions,7,3,0,15,0,25,Titans,0,14,7,7,0,28,4:2001:True:False,True,False
Bengals,14,0,3,0,0,17,Colts,7,10,3,3,0,23,4:2001:True:False,True,False
Steelers,6,7,0,7,0,20,Bills,0,0,0,0,0,0,4:2001:True:False,True,False
Patriots,0,17,3,13,0,33,Redskins,3,7,3,0,0,13,4:2001:True:False,True,False
Cowboys,14,3,7,3,0,27,Jaguars,14,3,0,0,0,17,4:2001:True:False,True,False
Ravens,0,10,14,14,0,38,Giants,6,3,0,0,0,9,4:2001:True:False,True,False
Dolphins,0,7,0,0,0,7,Vikings,0,10,3,7,0,20,4:2001:True:False,True,False
Falcons,10,6,13,7,0,36,Buccaneers,7,0,0,0,0,7,4:2001:True:False,True,False
Panthers,6,7,0,10,0,23,Browns,10,3,0,7,0,20,4:2001:True:False,True,False
Rams,0,0,7,14,0,21,Chiefs,0,14,3,0,0,17,4:2001:True:False,True,False
Cardinals,7,3,3,3,0,16,Chargers,0,3,0,0,0,3,4:2001:True:False,True,False
Broncos,7,14,7,7,0,35,49ers,7,0,0,0,0,7,4:2001:True:False,True,False
Raiders,10,7,7,0,0,24,Packers,7,3,0,3,0,13,4:2001:True:False,True,False
Seahawks,14,0,7,7,0,28,Saints,0,7,0,7,0,14,4:2001:True:False,True,False
Vikings,0,0,13,0,0,13,Panthers,7,3,7,7,0,24,1:2001:False:False,False,False
Cowboys,3,0,3,0,0,6,Buccaneers,3,0,0,7,0,10,1:2001:False:False,False,False
Browns,0,3,0,3,0,6,Seahawks,0,3,3,3,0,9,1:2001:False:False,False,False
Jaguars,0,21,0,0,0,21,Steelers,0,3,0,0,0,3,1:2001:False:False,False,False
Ravens,0,3,7,7,0,17,Bears,3,0,3,0,0,6,1:2001:False:False,False,False
Packers,21,0,7,0,0,28,Lions,3,3,0,0,0,6,1:2001:False:False,False,False
Jets,7,7,3,7,0,24,Colts,3,28,7,7,0,45,1:2001:False:False,False,False
Bengals,0,10,13,0,0,23,Patriots,0,10,0,7,0,17,1:2001:False:False,False,False
Bills,3,3,0,0,0,6,Saints,0,0,17,7,0,24,1:2001:False:False,False,False
Chiefs,7,7,3,7,0,24,Raiders,6,0,8,13,0,27,1:2001:False:False,False,False
Chargers,10,10,0,10,0,30,Redskins,0,0,3,0,0,3,1:2001:False:False,False,False
Eagles,3,0,0,14,0,17,Rams,7,7,3,0,3,20,1:2001:False:False,False,False
49ers,0,3,0,10,3,16,Falcons,7,3,3,0,0,13,1:2001:False:False,False,False
Titans,0,7,7,9,0,23,Dolphins,10,7,7,7,0,31,1:2001:False:False,False,False
Broncos,7,7,7,10,0,31,Giants,0,7,7,6,0,20,1:2001:False:False,False,False
Dolphins,0,7,3,8,0,18,Raiders,3,3,3,6,0,15,2:2001:False:False,False,False
Chiefs,0,0,3,0,0,3,Giants,3,10,0,0,0,13,2:2001:False:False,False,False
Browns,7,7,10,0,0,24,Lions,0,0,7,7,0,14,2:2001:False:False,False,False
Falcons,7,3,7,7,0,24,Panthers,3,7,3,3,0,16,2:2001:False:False,False,False
Cowboys,0,14,0,7,0,21,Chargers,14,6,6,6,0,32,2:2001:False:False,False,False
Jaguars,3,7,3,0,0,13,Titans,3,3,0,0,0,6,2:2001:False:False,False,False
Bears,0,0,3,14,0,17,Vikings,3,0,7,0,0,10,2:2001:False:False,False,False
Bengals,0,0,14,7,0,21,Ravens,3,0,0,7,0,10,2:2001:False:False,False,False
Colts,14,21,7,0,0,42,Bills,7,10,3,6,0,26,2:2001:False:False,False,False
Patriots,3,0,0,0,0,3,Jets,0,3,7,0,0,10,2:2001:False:False,False,False
49ers,0,16,0,10,0,26,Rams,9,3,10,8,0,30,2:2001:False:False,False,False
Seahawks,0,3,0,0,0,3,Eagles,3,14,0,10,0,27,2:2001:False:False,False,False
Cardinals,3,7,0,7,0,17,Broncos,0,17,14,7,0,38,2:2001:False:False,False,False
Packers,7,3,10,17,0,37,Redskins,0,0,0,0,0,0,2:2001:False:False,False,False
Redskins,3,7,3,0,0,13,Chiefs,0,28,7,10,0,45,3:2001:False:False,False,False
Vikings,7,3,3,7,0,20,Buccaneers,3,3,3,7,0,16,3:2001:False:False,False,False
Bills,0,3,0,0,0,3,Steelers,7,3,0,10,0,20,3:2001:False:False,False,False
Giants,0,14,0,7,0,21,Saints,0,3,0,10,0,13,3:2001:False:False,False,False
Rams,7,14,7,14,0,42,Dolphins,7,3,0,0,0,10,3:2001:False:False,False,False
Patriots,7,13,3,21,0,44,Colts,0,0,7,6,0,13,3:2001:False:False,False,False
Panthers,0,7,0,0,0,7,Packers,0,6,15,7,0,28,3:2001:False:False,False,False
Cardinals,0,0,7,7,0,14,Falcons,10,3,7,14,0,34,3:2001:False:False,False,False
Raiders,7,17,14,0,0,38,Seahawks,0,0,7,7,0,14,3:2001:False:False,False,False
Jaguars,0,0,14,0,0,14,Browns,3,10,0,10,0,23,3:2001:False:False,False,False
Chargers,0,7,14,7,0,28,Bengals,0,7,0,7,0,14,3:2001:False:False,False,False
Broncos,10,0,3,0,0,13,Ravens,3,3,7,7,0,20,3:2001:False:False,False,False
Eagles,7,26,7,0,0,40,Cowboys,6,0,0,12,0,18,3:2001:False:False,False,False
Jets,7,0,3,7,0,17,49ers,0,13,3,3,0,19,3:2001:False:False,False,False
Steelers,0,10,0,6,0,16,Bengals,0,0,0,7,0,7,4:2001:False:False,False,False
Eagles,7,10,0,3,0,20,Cardinals,14,0,0,7,0,21,4:2001:False:False,False,False
Falcons,0,0,0,3,0,3,Bears,0,10,0,21,0,31,4:2001:False:False,False,False
Giants,3,6,0,14,0,23,Redskins,3,3,3,0,0,9,4:2001:False:False,False,False
Ravens,7,10,3,6,0,26,Titans,0,0,7,0,0,7,4:2001:False:False,False,False
Browns,0,10,0,10,0,20,Chargers,3,0,7,6,0,16,4:2001:False:False,False,False
Dolphins,7,10,10,3,0,30,Patriots,7,3,0,0,0,10,4:2001:False:False,False,False
Saints,6,9,10,3,0,28,Vikings,7,0,8,0,0,15,4:2001:False:False,False,False
Bills,6,9,7,14,0,36,Jets,21,7,14,0,0,42,4:2001:False:False,False,False
Broncos,7,3,3,7,0,20,Chiefs,0,6,0,0,0,6,4:2001:False:False,False,False
Seahawks,14,7,0,3,0,24,Jaguars,3,9,3,0,0,15,4:2001:False:False,False,False
Raiders,7,14,7,0,0,28,Cowboys,0,7,7,7,0,21,4:2001:False:False,False,False
Buccaneers,0,7,0,7,0,14,Packers,0,7,3,0,0,10,4:2001:False:False,False,False
49ers,0,10,14,0,0,24,Panthers,0,7,7,0,0,14,4:2001:False:False,False,False
Lions,0,0,0,0,0,0,Rams,7,14,0,14,0,35,4:2001:False:False,False,False
Packers,0,17,7,7,0,31,Ravens,7,0,3,13,0,23,5:2001:False:False,False,False
Bengals,3,0,10,11,0,24,Browns,7,0,0,7,0,14,5:2001:False:False,False,False
Vikings,7,17,7,0,0,31,Lions,3,3,7,13,0,26,5:2001:False:False,False,False
Bears,3,10,7,0,0,20,Cardinals,0,6,0,7,0,13,5:2001:False:False,False,False
Panthers,0,6,6,13,0,25,Saints,10,7,3,7,0,27,5:2001:False:False,False,False
Titans,7,10,0,11,3,31,Buccaneers,0,7,7,14,0,28,5:2001:False:False,False,False
Falcons,14,6,0,11,0,31,49ers,0,7,10,14,6,37,5:2001:False:False,False,False
Rams,6,3,0,6,0,15,Giants,7,0,0,7,0,14,5:2001:False:False,False,False
Chiefs,0,2,0,15,0,17,Steelers,0,6,14,0,0,20,5:2001:False:False,False,False
Patriots,3,6,7,10,3,29,Chargers,3,3,7,13,0,26,5:2001:False:False,False,False
Seahawks,10,14,7,3,0,34,Broncos,0,14,0,7,0,21,5:2001:False:False,False,False
Jets,0,0,14,7,0,21,Dolphins,7,10,0,0,0,17,5:2001:False:False,False,False
Colts,0,9,6,3,0,18,Raiders,3,10,7,3,0,23,5:2001:False:False,False,False
Cowboys,0,3,0,6,0,9,Redskins,0,0,0,7,0,7,5:2001:False:False,False,False
Jaguars,0,0,7,3,0,10,Bills,0,3,7,3,0,13,6:2001:False:False,False,False
Saints,0,10,0,3,0,13,Falcons,10,0,0,10,0,20,6:2001:False:False,False,False
Browns,7,3,14,0,0,24,Ravens,0,6,0,8,0,14,6:2001:False:False,False,False
Redskins,0,0,0,14,3,17,Panthers,7,0,0,7,0,14,6:2001:False:False,False,False
Buccaneers,0,3,0,7,0,10,Steelers,0,7,10,0,0,17,6:2001:False:False,False,False
Jets,0,7,0,7,0,14,Rams,0,21,10,3,0,34,6:2001:False:False,False,False
Lions,0,14,0,10,0,24,Titans,3,6,8,10,0,27,6:2001:False:False,False,False
Bengals,0,0,0,0,0,0,Bears,3,7,7,7,0,24,6:2001:False:False,False,False
Colts,3,3,11,0,0,17,Patriots,7,21,3,7,0,38,6:2001:False:False,False,False
Cardinals,0,3,7,14,0,24,Chiefs,3,6,0,7,0,16,6:2001:False:False,False,False
Chargers,7,6,7,7,0,27,Broncos,0,7,3,0,0,10,6:2001:False:False,False,False
Vikings,0,20,0,15,0,35,Packers,0,0,7,6,0,13,6:2001:False:False,False,False
Giants,3,6,0,0,0,9,Eagles,0,0,3,7,0,10,6:2001:False:False,False,False
Chiefs,0,3,11,14,0,28,Colts,0,7,10,18,0,35,7:2001:False:False,False,False
Buccaneers,7,21,13,0,0,41,Vikings,0,0,8,6,0,14,7:2001:False:False,False,False
Bears,0,9,7,15,6,37,49ers,14,0,14,3,0,31,7:2001:False:False,False,False
Panthers,6,3,3,0,0,12,Jets,7,0,3,3,0,13,7:2001:False:False,False,False
Rams,14,10,0,7,0,31,Saints,3,3,25,3,0,34,7:2001:False:False,False,False
Ravens,0,3,3,12,0,18,Jaguars,0,3,7,7,0,17,7:2001:False:False,False,False
Lions,3,10,14,0,0,27,Bengals,7,14,3,7,0,31,7:2001:False:False,False,False
Redskins,14,3,10,8,0,35,Giants,0,14,0,7,0,21,7:2001:False:False,False,False
Cowboys,0,3,14,0,0,17,Cardinals,3,0,0,0,0,3,7:2001:False:False,False,False
Broncos,7,3,14,7,0,31,Patriots,10,7,3,0,0,20,7:2001:False:False,False,False
Seahawks,0,14,3,3,0,20,Dolphins,0,10,7,7,0,24,7:2001:False:False,False,False
Eagles,0,3,0,7,0,10,Raiders,7,3,7,3,0,20,7:2001:False:False,False,False
Chargers,10,3,0,14,0,27,Bills,0,10,0,14,0,24,7:2001:False:False,False,False
Steelers,7,10,10,7,0,34,Titans,0,7,0,0,0,7,7:2001:False:False,False,False
Dolphins,3,10,0,10,0,23,Panthers,3,3,0,0,0,6,8:2001:False:False,False,False
Giants,0,7,7,10,3,27,Cowboys,10,14,0,0,0,24,8:2001:False:False,False,False
Steelers,3,7,0,0,0,10,Ravens,0,7,0,6,0,13,8:2001:False:False,False,False
Titans,7,0,7,14,0,28,Jaguars,0,17,0,7,0,24,8:2001:False:False,False,False
Packers,7,0,7,7,0,21,Buccaneers,0,10,7,3,0,20,8:2001:False:False,False,False
Falcons,7,0,0,3,0,10,Patriots,0,17,7,0,0,24,8:2001:False:False,False,False
Bills,0,7,0,7,0,14,Colts,0,17,7,6,0,30,8:2001:False:False,False,False
Cardinals,0,7,0,0,0,7,Eagles,7,14,0,0,0,21,8:2001:False:False,False,False
49ers,0,7,7,7,0,21,Lions,7,3,3,0,0,13,8:2001:False:False,False,False
Chargers,0,0,10,10,0,20,Chiefs,9,10,0,6,0,25,8:2001:False:False,False,False
Bears,0,7,0,14,6,27,Browns,7,0,14,0,0,21,8:2001:False:False,False,False
Redskins,10,10,7,0,0,27,Seahawks,7,0,7,0,0,14,8:2001:False:False,False,False
Saints,0,0,9,0,0,9,Jets,6,7,0,3,0,16,8:2001:False:False,False,False
Raiders,7,14,7,10,0,38,Broncos,3,3,6,16,0,28,8:2001:False:False,False,False
Jaguars,7,0,21,2,0,30,Bengals,0,13,0,0,0,13,9:2001:False:False,False,False
Falcons,7,0,3,10,0,20,Cowboys,3,10,0,0,0,13,9:2001:False:False,False,False
Bears,6,3,3,0,0,12,Packers,0,10,7,3,0,20,9:2001:False:False,False,False
Browns,9,0,3,0,0,12,Steelers,3,3,3,3,3,15,9:2001:False:False,False,False
Colts,3,7,14,0,0,24,Dolphins,7,10,0,10,0,27,9:2001:False:False,False,False
Lions,0,0,7,10,0,17,Buccaneers,0,10,7,3,0,20,9:2001:False:False,False,False
Jets,0,14,13,0,0,27,Chiefs,0,0,0,7,0,7,9:2001:False:False,False,False
Patriots,7,0,7,7,0,21,Bills,0,3,0,8,0,11,9:2001:False:False,False,False
Rams,21,10,14,3,0,48,Panthers,0,7,7,0,0,14,9:2001:False:False,False,False
Broncos,3,17,6,0,0,26,Chargers,0,0,3,13,0,16,9:2001:False:False,False,False
Cardinals,0,7,3,0,0,10,Giants,7,7,0,3,0,17,9:2001:False:False,False,False
49ers,7,14,0,7,0,28,Saints,3,11,10,3,0,27,9:2001:False:False,False,False
Eagles,7,24,7,10,0,48,Vikings,0,10,0,7,0,17,9:2001:False:False,False,False
Seahawks,6,7,14,7,0,34,Raiders,3,7,10,7,0,27,9:2001:False:False,False,False
Titans,0,0,10,0,0,10,Ravens,0,0,10,6,0,16,9:2001:False:False,False,False
Bengals,7,0,0,0,0,7,Titans,10,0,7,3,0,20,10:2001:False:False,False,False
Ravens,0,7,10,0,0,17,Browns,3,17,0,7,0,27,10:2001:False:False,False,False
Packers,3,7,3,7,0,20,Falcons,6,10,0,7,0,23,10:2001:False:False,False,False
Bills,0,10,3,7,0,20,Seahawks,3,7,7,6,0,23,10:2001:False:False,False,False
Dolphins,0,0,0,0,0,0,Jets,7,7,7,3,0,24,10:2001:False:False,False,False
Cowboys,0,0,0,3,0,3,Eagles,0,20,6,10,0,36,10:2001:False:False,False,False
Panthers,7,3,3,9,0,22,49ers,0,7,7,8,3,25,10:2001:False:False,False,False
Saints,0,17,7,10,0,34,Colts,14,3,0,3,0,20,10:2001:False:False,False,False
Raiders,14,0,3,17,0,34,Chargers,7,0,10,7,0,24,10:2001:False:False,False,False
Steelers,3,3,7,7,0,20,Jaguars,0,0,7,0,0,7,10:2001:False:False,False,False
Broncos,0,10,0,0,0,10,Redskins,0,3,0,14,0,17,10:2001:False:False,False,False
Cardinals,7,7,7,24,0,45,Lions,0,14,17,7,0,38,10:2001:False:False,False,False
Buccaneers,3,6,0,15,0,24,Bears,0,7,17,3,0,27,10:2001:False:False,False,False
Patriots,7,3,0,7,0,17,Rams,7,7,3,7,0,24,10:2001:False:False,False,False
Vikings,7,7,0,14,0,28,Giants,10,3,3,0,0,16,10:2001:False:False,False,False
Lions,3,10,0,14,0,27,Packers,7,10,7,5,0,29,11:2001:False:False,False,False
Cowboys,3,0,0,21,0,24,Broncos,3,14,6,3,0,26,11:2001:False:False,False,False
Browns,3,9,0,6,0,18,Bengals,0,0,0,0,0,0,11:2001:False:False,False,False
Bills,7,7,7,6,0,27,Dolphins,7,3,0,24,0,34,11:2001:False:False,False,False
Panthers,0,0,0,7,0,7,Falcons,3,7,0,0,0,10,11:2001:False:False,False,False
Jaguars,0,0,7,14,0,21,Ravens,3,7,7,7,0,24,11:2001:False:False,False,False
Eagles,0,0,3,0,0,3,Redskins,0,10,0,3,0,13,11:2001:False:False,False,False
Chiefs,3,7,0,9,0,19,Seahawks,0,7,0,0,0,7,11:2001:False:False,False,False
Colts,7,7,7,0,0,21,49ers,3,17,7,13,0,40,11:2001:False:False,False,False
Titans,7,7,3,7,0,24,Steelers,3,7,14,10,0,34,11:2001:False:False,False,False
Chargers,3,0,0,14,0,17,Cardinals,0,7,3,10,0,20,11:2001:False:False,False,False
Patriots,7,13,0,14,0,34,Saints,0,0,10,7,0,17,11:2001:False:False,False,False
Giants,3,0,7,0,0,10,Raiders,7,14,0,7,0,28,11:2001:False:False,False,False
Vikings,0,0,3,3,0,6,Bears,0,10,0,3,0,13,11:2001:False:False,False,False
Rams,3,6,8,0,0,17,Buccaneers,0,10,7,7,0,24,11:2001:False:False,False,False
Chiefs,0,3,7,0,0,10,Eagles,3,10,7,3,0,23,12:2001:False:False,False,False
Saints,0,10,3,14,0,27,Panthers,7,0,3,13,0,23,12:2001:False:False,False,False
Browns,0,7,0,8,0,15,Titans,14,3,14,0,0,31,12:2001:False:False,False,False
Bengals,3,0,0,10,0,13,Buccaneers,0,7,3,3,3,16,12:2001:False:False,False,False
Dolphins,0,0,0,21,0,21,Broncos,0,3,7,0,0,10,12:2001:False:False,False,False
Bears,0,3,0,10,0,13,Lions,7,0,3,0,0,10,12:2001:False:False,False,False
Ravens,3,13,10,13,0,39,Colts,3,7,17,0,0,27,12:2001:False:False,False,False
Steelers,0,7,14,0,0,21,Vikings,3,0,0,13,0,16,12:2001:False:False,False,False
Jets,10,3,3,0,0,16,Patriots,0,0,14,3,0,17,12:2001:False:False,False,False
Seahawks,7,0,3,0,3,13,Chargers,0,3,7,0,0,10,12:2001:False:False,False,False
Falcons,3,3,0,0,0,6,Rams,14,0,14,7,0,35,12:2001:False:False,False,False
Redskins,0,0,7,7,0,14,Cowboys,7,0,0,13,0,20,12:2001:False:False,False,False
Raiders,7,0,7,17,0,31,Cardinals,7,13,0,11,3,34,12:2001:False:False,False,False
49ers,0,14,7,14,0,35,Bills,0,0,0,0,0,0,12:2001:False:False,False,False
Jaguars,3,10,8,0,0,21,Packers,0,7,14,7,0,28,12:2001:False:False,False,False
Vikings,0,14,14,14,0,42,Titans,10,0,0,14,0,24,13:2001:False:False,False,False
Eagles,14,7,0,3,0,24,Chargers,7,7,0,0,0,14,13:2001:False:False,False,False
Rams,14,7,3,3,0,27,49ers,0,7,0,7,0,14,13:2001:False:False,False,False
Cowboys,3,3,7,7,0,20,Giants,6,7,0,0,0,13,13:2001:False:False,False,False
Falcons,7,3,0,0,0,10,Saints,14,0,0,14,0,28,13:2001:False:False,False,False
Bengals,0,7,3,0,0,10,Jaguars,7,0,0,7,0,14,13:2001:False:False,False,False
Bills,3,10,6,6,0,25,Panthers,3,21,0,0,0,24,13:2001:False:False,False,False
Packers,7,0,7,3,0,17,Bears,0,0,7,0,0,7,13:2001:False:False,False,False
Patriots,3,17,0,7,0,27,Browns,10,0,3,3,0,16,13:2001:False:False,False,False
Buccaneers,0,7,0,8,0,15,Lions,0,3,6,3,0,12,13:2001:False:False,False,False
Cardinals,0,3,0,7,0,10,Redskins,0,10,0,10,0,20,13:2001:False:False,False,False
Raiders,7,14,7,0,0,28,Chiefs,10,7,3,6,0,26,13:2001:False:False,False,False
Steelers,3,9,0,6,0,18,Jets,0,7,0,0,0,7,13:2001:False:False,False,False
Broncos,7,3,10,0,0,20,Seahawks,0,7,0,0,0,7,13:2001:False:False,False,False
Dolphins,7,13,0,21,0,41,Colts,0,3,3,0,0,6,13:2001:False:False,False,False
Giants,7,0,0,10,0,17,Cardinals,3,3,0,7,0,13,14:2001:False:False,False,False
Chargers,0,3,0,3,0,6,Raiders,3,0,7,3,0,13,14:2001:False:False,False,False
Colts,7,21,0,13,0,41,Falcons,0,14,3,10,0,27,14:2001:False:False,False,False
Jets,0,3,0,12,0,15,Bengals,7,0,7,0,0,14,14:2001:False:False,False,False
Bears,3,10,7,7,0,27,Buccaneers,0,3,0,0,0,3,14:2001:False:False,False,False
Chiefs,10,3,7,3,3,26,Broncos,0,10,7,6,0,23,14:2001:False:False,False,False
Bills,0,0,3,6,0,9,Patriots,3,3,0,3,3,12,14:2001:False:False,False,False
Lions,14,6,0,7,0,27,Vikings,7,0,17,0,0,24,14:2001:False:False,False,False
Browns,0,0,7,3,0,10,Jaguars,9,0,0,6,0,15,14:2001:False:False,False,False
Redskins,3,3,0,0,0,6,Eagles,0,10,7,3,0,20,14:2001:False:False,False,False
49ers,14,0,7,0,0,21,Dolphins,0,0,0,0,0,0,14:2001:False:False,False,False
Titans,2,13,3,8,0,26,Packers,10,3,0,7,0,20,14:2001:False:False,False,False
Seahawks,10,0,2,17,0,29,Cowboys,0,3,0,0,0,3,14:2001:False:False,False,False
Ravens,0,7,0,14,0,21,Steelers,3,10,0,13,0,26,14:2001:False:False,False,False
Saints,7,7,7,0,0,21,Rams,7,14,7,6,0,34,14:2001:False:False,False,False
Patriots,0,20,0,0,0,20,Dolphins,0,3,0,10,0,13,15:2001:False:False,False,False
49ers,0,3,3,7,0,13,Eagles,0,3,0,0,0,3,15:2001:False:False,False,False
Raiders,0,0,0,10,0,10,Titans,0,0,10,3,0,13,15:2001:False:False,False,False
Giants,7,10,0,10,0,27,Seahawks,7,10,7,0,0,24,15:2001:False:False,False,False
Chiefs,7,0,3,10,0,20,Chargers,7,0,7,3,0,17,15:2001:False:False,False,False
Panthers,7,6,10,9,0,32,Rams,7,14,10,7,0,38,15:2001:False:False,False,False
Falcons,10,3,10,10,0,33,Bills,7,7,6,10,0,30,15:2001:False:False,False,False
Steelers,14,13,10,10,0,47,Lions,7,7,0,0,0,14,15:2001:False:False,False,False
Ravens,3,10,0,3,0,16,Bengals,0,0,0,0,0,0,15:2001:False:False,False,False
Buccaneers,17,13,3,15,0,48,Saints,0,0,7,14,0,21,15:2001:False:False,False,False
Vikings,0,3,0,0,0,3,Jaguars,10,6,7,10,0,33,15:2001:False:False,False,False
Redskins,7,3,3,2,0,15,Bears,3,7,0,10,0,20,15:2001:False:False,False,False
Cardinals,0,17,0,0,0,17,Cowboys,3,7,0,0,0,10,15:2001:False:False,False,False
Packers,13,10,0,7,0,30,Browns,0,7,0,0,0,7,15:2001:False:False,False,False
Colts,0,10,7,11,0,28,Jets,3,10,6,10,0,29,15:2001:False:False,False,False
Buccaneers,3,13,0,6,0,22,Ravens,0,7,0,3,0,10,16:2001:False:False,False,False
Jaguars,7,10,0,9,0,26,Chiefs,7,10,10,3,0,30,16:2001:False:False,False,False
Rams,7,28,0,7,0,42,Colts,7,7,3,0,0,17,16:2001:False:False,False,False
Packers,0,7,0,17,0,24,Vikings,0,3,3,7,0,13,16:2001:False:False,False,False
Titans,14,10,7,7,0,38,Browns,14,10,0,17,0,41,16:2001:False:False,False,False
Lions,0,0,0,0,0,0,Bears,14,3,0,7,0,24,16:2001:False:False,False,False
Jets,3,3,0,3,0,9,Bills,0,7,7,0,0,14,16:2001:False:False,False,False
Dolphins,7,14,0,0,0,21,Falcons,7,0,0,7,0,14,16:2001:False:False,False,False
Bengals,0,10,0,13,3,26,Steelers,14,3,6,0,0,23,16:2001:False:False,False,False
Cowboys,0,10,14,3,0,27,49ers,0,14,0,7,0,21,16:2001:False:False,False,False
Panthers,0,7,0,0,0,7,Cardinals,7,20,3,0,0,30,16:2001:False:False,False,False
Eagles,7,0,0,17,0,24,Giants,0,0,10,11,0,21,16:2001:False:False,False,False
Chargers,10,3,3,6,0,22,Seahawks,0,14,8,3,0,25,16:2001:False:False,False,False
Broncos,3,10,0,10,0,23,Raiders,3,7,7,0,0,17,16:2001:False:False,False,False
Saints,10,0,0,0,0,10,Redskins,0,13,17,10,0,40,16:2001:False:False,False,False
Colts,9,10,3,7,0,29,Broncos,0,7,3,0,0,10,17:2001:False:False,False,False
Redskins,0,6,6,8,0,20,Cardinals,7,10,0,0,0,17,17:2001:False:False,False,False
Steelers,0,7,14,7,0,28,Browns,7,0,0,0,0,7,17:2001:False:False,False,False
Saints,0,0,0,0,0,0,49ers,14,7,3,14,0,38,17:2001:False:False,False,False
Panthers,0,3,3,0,0,6,Patriots,10,0,14,14,0,38,17:2001:False:False,False,False
Bears,3,10,10,10,0,33,Jaguars,0,0,6,7,0,13,17:2001:False:False,False,False
Titans,7,7,7,0,0,21,Bengals,0,14,6,3,0,23,17:2001:False:False,False,False
Lions,0,6,3,6,0,15,Cowboys,0,7,0,3,0,10,17:2001:False:False,False,False
Giants,7,3,0,15,0,25,Packers,14,3,17,0,0,34,17:2001:False:False,False,False
Rams,10,7,14,0,0,31,Falcons,0,6,7,0,0,13,17:2001:False:False,False,False
Seahawks,0,14,7,0,0,21,Chiefs,0,0,10,8,0,18,17:2001:False:False,False,False
Raiders,3,13,3,3,0,22,Jets,7,7,7,3,0,24,17:2001:False:False,False,False
Dolphins,3,10,0,21,0,34,Bills,0,0,7,0,0,7,17:2001:False:False,False,False
Buccaneers,3,10,0,0,0,13,Eagles,0,3,0,14,0,17,17:2001:False:False,False,False
Ravens,0,9,3,7,0,19,Vikings,3,0,0,0,0,3,17:2001:False:False,False,False
Eagles,3,14,7,7,0,31,Buccaneers,3,6,0,0,0,9,18:2001:False:True,False,True
Raiders,6,10,0,22,0,38,Jets,0,3,7,14,0,24,18:2001:False:True,False,True
Packers,6,0,9,10,0,25,49ers,0,7,0,8,0,15,18:2001:False:True,False,True
Dolphins,3,0,0,0,0,3,Ravens,0,7,7,6,0,20,18:2001:False:True,False,True
Bears,0,7,7,5,0,19,Eagles,6,7,7,13,0,33,19:2001:False:True,False,True
Patriots,0,0,3,10,3,16,Raiders,0,7,6,0,0,13,19:2001:False:True,False,True
Steelers,10,10,0,7,0,27,Ravens,0,3,7,0,0,10,19:2001:False:True,False,True
Rams,7,17,14,7,0,45,Packers,7,3,0,7,0,17,19:2001:False:True,False,True
Steelers,0,3,14,0,0,17,Patriots,7,7,7,3,0,24,20:2001:False:True,False,True
Rams,10,3,9,7,0,29,Eagles,3,14,0,7,0,24,20:2001:False:True,False,True
Patriots,0,14,3,3,0,20,Rams,3,0,0,14,0,17,21:2001:False:True,False,True
Steelers,0,3,3,0,0,6,Jets,7,3,3,3,0,16,1:2002:True:False,True,False
Bills,7,10,0,0,0,17,Bengals,7,7,7,3,0,24,1:2002:True:False,True,False
Falcons,3,3,7,10,0,23,Jaguars,0,6,0,7,0,13,1:2002:True:False,True,False
Ravens,0,3,3,6,0,12,Lions,0,6,0,0,0,6,1:2002:True:False,True,False
Cowboys,3,14,0,3,0,20,Raiders,3,3,0,0,0,6,1:2002:True:False,True,False
Seahawks,10,0,0,0,0,10,Colts,0,7,14,7,0,28,1:2002:True:False,True,False
49ers,7,0,7,0,0,14,Chiefs,7,0,7,0,3,17,1:2002:True:False,True,False
Eagles,0,10,3,7,0,20,Packers,0,10,0,3,0,13,1:2002:True:False,True,False
Giants,7,7,0,8,0,22,Patriots,3,10,0,6,0,19,1:2002:True:False,True,False
Titans,0,7,7,14,0,28,Rams,10,3,7,6,0,26,1:2002:True:False,True,False
Panthers,0,10,6,14,0,30,Redskins,3,17,3,14,0,37,1:2002:True:False,True,False
Saints,0,7,3,0,0,10,Texans,0,3,7,3,0,13,1:2002:True:False,True,False
Bears,3,0,0,0,0,3,Broncos,0,13,7,7,0,27,1:2002:True:False,True,False
Vikings,7,0,0,8,0,15,Browns,7,6,14,0,0,27,1:2002:True:False,True,False
Chargers,0,10,7,0,0,17,Cardinals,7,7,7,3,0,24,1:2002:True:False,True,False
Buccaneers,7,7,0,0,0,14,Dolphins,0,7,0,3,0,10,1:2002:True:False,True,False
Dolphins,0,7,0,0,0,7,Saints,3,14,0,7,0,24,2:2002:True:False,True,False
Titans,21,0,3,0,0,24,Raiders,0,7,0,7,0,14,2:2002:True:False,True,False
Ravens,3,0,7,6,0,16,Jets,10,3,21,0,0,34,2:2002:True:False,True,False
Rams,7,3,0,7,0,17,Bears,10,0,0,9,0,19,2:2002:True:False,True,False
Jaguars,0,0,0,0,0,0,Buccaneers,0,13,0,7,0,20,2:2002:True:False,True,False
Bills,6,7,6,2,0,21,Vikings,7,10,0,7,0,24,2:2002:True:False,True,False
Chargers,7,3,7,7,0,24,Seahawks,0,7,0,7,0,14,2:2002:True:False,True,False
Falcons,10,13,3,10,0,36,Giants,7,7,3,7,0,24,2:2002:True:False,True,False
Colts,7,3,0,0,0,10,Bengals,0,3,13,6,0,22,2:2002:True:False,True,False
Patriots,3,0,7,6,0,16,Eagles,0,6,3,6,0,15,2:2002:True:False,True,False
Browns,3,7,7,7,0,24,Lions,0,13,3,7,0,23,2:2002:True:False,True,False
Panthers,10,3,3,0,0,16,Cowboys,0,6,7,6,0,19,2:2002:True:False,True,False
Chiefs,7,6,6,0,0,19,Texans,3,3,0,3,0,9,2:2002:True:False,True,False
Cardinals,7,0,0,14,0,21,Packers,10,3,16,0,0,29,2:2002:True:False,True,False
Redskins,0,0,14,21,0,35,Steelers,0,17,17,0,0,34,2:2002:True:False,True,False
Broncos,7,0,0,0,0,7,49ers,3,3,3,3,0,12,2:2002:True:False,True,False
Rams,0,0,0,10,0,10,Chargers,0,3,21,7,0,31,3:2002:True:False,True,False
Bears,3,10,0,3,0,16,Jaguars,0,0,10,14,0,24,3:2002:True:False,True,False
Vikings,0,14,0,0,0,14,Titans,0,3,0,7,0,10,3:2002:True:False,True,False
Patriots,3,3,14,3,0,23,Panthers,3,0,0,0,0,3,3:2002:True:False,True,False
Eagles,3,3,0,6,0,12,Ravens,0,3,7,3,0,13,3:2002:True:False,True,False
Lions,10,6,6,0,0,22,Steelers,7,14,6,7,0,34,3:2002:True:False,True,False
Colts,10,3,3,3,0,19,Bills,7,0,0,0,0,7,3:2002:True:False,True,False
Seahawks,0,10,0,7,0,17,Chiefs,0,0,7,7,0,14,3:2002:True:False,True,False
Bengals,3,6,7,7,0,23,Saints,7,14,10,0,0,31,3:2002:True:False,True,False
Buccaneers,0,7,3,0,0,10,Redskins,7,9,10,14,0,40,3:2002:True:False,True,False
Cowboys,0,6,7,6,0,19,Falcons,0,7,0,14,0,21,3:2002:True:False,True,False
Cardinals,3,7,0,3,0,13,Broncos,0,13,0,6,0,19,3:2002:True:False,True,False
Texans,0,0,0,3,0,3,Dolphins,7,10,7,0,0,24,3:2002:True:False,True,False
Jets,7,0,14,7,0,28,Giants,0,0,0,7,0,7,3:2002:True:False,True,False
Raiders,7,3,0,7,0,17,49ers,0,7,0,3,0,10,3:2002:True:False,True,False
Packers,0,10,10,7,0,27,Browns,14,0,3,3,0,20,3:2002:True:False,True,False
49ers,14,10,0,3,0,27,Chargers,0,3,0,0,0,3,4:2002:True:False,True,False
Dolphins,10,7,7,0,0,24,Bears,7,0,7,8,0,22,4:2002:True:False,True,False
Bengals,7,0,0,7,0,14,Falcons,0,21,3,3,0,27,4:2002:True:False,True,False
Steelers,7,7,3,0,0,17,Vikings,0,7,0,7,0,14,4:2002:True:False,True,False
Giants,0,3,3,7,0,13,Ravens,0,0,0,0,0,0,4:2002:True:False,True,False
Jaguars,2,0,14,9,0,25,Cowboys,0,21,0,7,0,28,4:2002:True:False,True,False
Redskins,0,0,7,7,0,14,Patriots,0,21,0,7,0,28,4:2002:True:False,True,False
Lions,7,3,7,3,0,20,Bills,7,3,0,3,0,13,4:2002:True:False,True,False
Broncos,21,3,0,7,0,31,Seahawks,0,0,0,0,0,0,4:2002:True:False,True,False
Raiders,0,10,14,7,0,31,Cardinals,0,3,0,0,0,3,4:2002:True:False,True,False
Saints,0,10,12,3,0,25,Colts,7,14,0,0,0,21,4:2002:True:False,True,False
Jets,3,17,0,3,0,23,Eagles,0,6,10,0,0,16,4:2002:True:False,True,False
Texans,0,10,3,0,0,13,Buccaneers,14,0,3,0,0,17,4:2002:True:False,True,False
Packers,0,3,3,15,0,21,Titans,0,0,7,13,0,20,4:2002:True:False,True,False
Browns,13,3,3,0,0,19,Panthers,0,3,3,14,0,20,4:2002:True:False,True,False
Chiefs,0,3,10,10,0,23,Rams,6,10,0,0,0,16,4:2002:True:False,True,False
Giants,3,3,0,7,0,13,49ers,3,0,7,6,0,16,1:2002:False:False,False,False
Redskins,3,7,14,7,0,31,Cardinals,10,3,3,7,0,23,1:2002:False:False,False,False
Bears,7,3,3,14,0,27,Vikings,3,17,0,3,0,23,1:2002:False:False,False,False
Browns,6,14,7,12,0,39,Chiefs,7,7,3,23,0,40,1:2002:False:False,False,False
Jaguars,0,7,10,8,0,25,Colts,7,7,7,7,0,28,1:2002:False:False,False,False
Dolphins,7,21,14,7,0,49,Lions,0,7,7,7,0,21,1:2002:False:False,False,False
Bills,3,14,7,7,0,31,Jets,0,17,3,11,6,37,1:2002:False:False,False,False
Packers,3,10,14,7,3,37,Falcons,0,21,3,10,0,34,1:2002:False:False,False,False
Titans,7,3,3,14,0,27,Eagles,14,10,0,0,0,24,1:2002:False:False,False,False
Panthers,7,3,0,0,0,10,Ravens,7,0,0,0,0,7,1:2002:False:False,False,False
Bengals,0,0,3,3,0,6,Chargers,10,10,7,7,0,34,1:2002:False:False,False,False
Broncos,7,9,0,7,0,23,Rams,0,6,7,3,0,16,1:2002:False:False,False,False
Buccaneers,0,3,7,10,0,20,Saints,6,7,7,0,6,26,1:2002:False:False,False,False
Raiders,7,21,3,0,0,31,Seahawks,7,0,0,10,0,17,1:2002:False:False,False,False
Texans,7,3,0,9,0,19,Cowboys,0,3,7,0,0,10,1:2002:False:False,False,False
Patriots,7,3,17,3,0,30,Steelers,7,0,0,7,0,14,1:2002:False:False,False,False
Ravens,0,0,0,0,0,0,Buccaneers,10,3,5,7,0,25,2:2002:False:False,False,False
Browns,3,14,0,3,0,20,Bengals,0,0,0,7,0,7,2:2002:False:False,False,False
Cowboys,0,7,7,7,0,21,Titans,7,3,0,3,0,13,2:2002:False:False,False,False
Jets,0,0,7,0,0,7,Patriots,0,10,17,17,0,44,2:2002:False:False,False,False
Falcons,0,10,3,0,0,13,Bears,0,7,7,0,0,14,2:2002:False:False,False,False
Saints,7,14,7,7,0,35,Packers,0,10,7,3,0,20,2:2002:False:False,False,False
Chiefs,3,3,0,10,0,16,Jaguars,0,9,0,14,0,23,2:2002:False:False,False,False
Colts,0,3,0,10,0,13,Dolphins,14,7,0,0,0,21,2:2002:False:False,False,False
Panthers,0,10,14,7,0,31,Lions,0,0,7,0,0,7,2:2002:False:False,False,False
Seahawks,3,7,0,3,0,13,Cardinals,3,0,7,14,0,24,2:2002:False:False,False,False
Rams,0,7,7,7,0,21,Giants,3,14,3,6,0,26,2:2002:False:False,False,False
Vikings,3,10,13,13,0,39,Bills,6,7,10,16,6,45,2:2002:False:False,False,False
Chargers,14,3,0,7,0,24,Texans,0,3,0,0,0,3,2:2002:False:False,False,False
49ers,0,7,0,7,0,14,Broncos,0,3,7,14,0,24,2:2002:False:False,False,False
Steelers,7,3,7,0,0,17,Raiders,10,7,3,10,0,30,2:2002:False:False,False,False
Redskins,0,7,0,0,0,7,Eagles,14,9,7,7,0,37,2:2002:False:False,False,False
Texans,0,0,3,0,0,3,Colts,7,6,0,10,0,23,3:2002:False:False,False,False
Titans,7,14,0,7,0,28,Browns,7,0,7,14,3,31,3:2002:False:False,False,False
Patriots,0,9,8,21,3,41,Chiefs,3,7,7,21,0,38,3:2002:False:False,False,False
Dolphins,10,3,0,17,0,30,Jets,0,3,0,0,0,3,3:2002:False:False,False,False
Bears,10,10,0,3,0,23,Saints,0,14,7,8,0,29,3:2002:False:False,False,False
Vikings,0,7,0,7,0,14,Panthers,0,0,7,14,0,21,3:2002:False:False,False,False
Eagles,3,17,14,10,0,44,Cowboys,10,0,3,0,0,13,3:2002:False:False,False,False
Cardinals,7,0,0,8,0,15,Chargers,0,14,0,9,0,23,3:2002:False:False,False,False
Broncos,7,7,7,7,0,28,Bills,0,7,3,13,0,23,3:2002:False:False,False,False
Lions,7,10,0,14,0,31,Packers,7,10,14,6,0,37,3:2002:False:False,False,False
Giants,0,0,3,6,0,9,Seahawks,3,3,0,0,0,6,3:2002:False:False,False,False
49ers,7,10,3,0,0,20,Redskins,0,10,0,0,0,10,3:2002:False:False,False,False
Falcons,13,7,7,3,0,30,Bengals,0,3,0,0,0,3,3:2002:False:False,False,False
Buccaneers,3,10,0,13,0,26,Rams,7,0,0,7,0,14,3:2002:False:False,False,False
Jaguars,7,7,14,0,0,28,Jets,0,3,0,0,0,3,4:2002:False:False,False,False
Bills,7,10,3,7,6,33,Bears,7,7,3,10,0,27,4:2002:False:False,False,False
Steelers,0,6,0,7,3,16,Browns,3,3,0,7,0,13,4:2002:False:False,False,False
Packers,3,7,0,7,0,17,Panthers,7,0,0,7,0,14,4:2002:False:False,False,False
Rams,0,7,3,0,0,10,Cowboys,7,0,0,6,0,13,4:2002:False:False,False,False
Lions,13,7,3,3,0,26,Saints,0,7,8,6,0,21,4:2002:False:False,False,False
Chiefs,10,14,7,17,0,48,Dolphins,7,9,7,7,0,30,4:2002:False:False,False,False
Eagles,3,17,8,7,0,35,Texans,7,0,10,0,0,17,4:2002:False:False,False,False
Cardinals,0,7,0,14,0,21,Giants,7,0,0,0,0,7,4:2002:False:False,False,False
Bengals,7,0,0,0,0,7,Buccaneers,0,21,7,7,0,35,4:2002:False:False,False,False
Raiders,21,10,7,14,0,52,Titans,7,0,12,6,0,25,4:2002:False:False,False,False
Chargers,7,7,7,0,0,21,Patriots,7,7,0,0,0,14,4:2002:False:False,False,False
Seahawks,14,31,0,3,0,48,Vikings,7,3,7,6,0,23,4:2002:False:False,False,False
Ravens,0,31,3,0,0,34,Broncos,3,0,13,7,0,23,4:2002:False:False,False,False
Titans,0,14,0,0,0,14,Redskins,3,7,14,7,0,31,5:2002:False:False,False,False
Colts,7,14,0,7,0,28,Bengals,0,7,7,7,0,21,5:2002:False:False,False,False
Dolphins,6,10,7,3,0,26,Patriots,0,0,6,7,0,13,5:2002:False:False,False,False
Panthers,0,7,6,0,0,13,Cardinals,0,6,0,10,0,16,5:2002:False:False,False,False
Cowboys,0,10,0,7,0,17,Giants,0,14,0,7,0,21,5:2002:False:False,False,False
Falcons,3,0,3,0,0,6,Buccaneers,0,3,7,10,0,20,5:2002:False:False,False,False
Saints,10,9,10,3,0,32,Steelers,0,14,7,8,0,29,5:2002:False:False,False,False
Bills,0,21,10,0,0,31,Raiders,7,14,7,21,0,49,5:2002:False:False,False,False
Jets,7,8,0,10,0,25,Chiefs,3,9,3,14,0,29,5:2002:False:False,False,False
Broncos,7,12,0,7,0,26,Chargers,0,0,3,6,0,9,5:2002:False:False,False,False
49ers,10,17,0,10,0,37,Rams,3,0,3,7,0,13,5:2002:False:False,False,False
Jaguars,3,11,0,14,0,28,Eagles,0,7,3,15,0,25,5:2002:False:False,False,False
Browns,0,0,0,21,0,21,Ravens,0,13,10,3,0,26,5:2002:False:False,False,False
Bears,7,7,0,7,0,21,Packers,14,10,7,3,0,34,5:2002:False:False,False,False
Redskins,0,21,0,6,0,27,Saints,13,16,7,7,0,43,6:2002:False:False,False,False
Colts,7,6,0,9,0,22,Ravens,6,0,7,7,0,20,6:2002:False:False,False,False
Bengals,0,0,7,0,0,7,Steelers,7,17,7,3,0,34,6:2002:False:False,False,False
Texans,3,14,0,7,0,24,Bills,3,7,7,14,0,31,6:2002:False:False,False,False
Buccaneers,7,3,0,7,0,17,Browns,0,0,0,3,0,3,6:2002:False:False,False,False
Giants,0,3,7,0,0,10,Falcons,0,10,0,7,0,17,6:2002:False:False,False,False
Cowboys,0,0,0,14,0,14,Panthers,7,0,3,3,0,13,6:2002:False:False,False,False
Patriots,0,3,0,7,0,10,Packers,0,14,7,7,0,28,6:2002:False:False,False,False
Vikings,3,7,7,14,0,31,Lions,14,7,3,0,0,24,6:2002:False:False,False,False
Titans,7,9,0,7,0,23,Jaguars,0,7,7,0,0,14,6:2002:False:False,False,False
Rams,7,7,0,14,0,28,Raiders,0,3,3,7,0,13,6:2002:False:False,False,False
Chargers,7,0,7,21,0,35,Chiefs,10,7,7,10,0,34,6:2002:False:False,False,False
Broncos,6,3,3,10,0,22,Dolphins,0,7,0,17,0,24,6:2002:False:False,False,False
Seahawks,7,7,7,0,0,21,49ers,10,3,7,8,0,28,6:2002:False:False,False,False
Saints,7,3,3,22,0,35,49ers,7,10,7,3,0,27,7:2002:False:False,False,False
Falcons,3,7,14,6,0,30,Panthers,0,0,0,0,0,0,7:2002:False:False,False,False
Lions,0,14,3,3,3,23,Bears,0,10,10,0,0,20,7:2002:False:False,False,False
Dolphins,7,3,0,0,0,10,Bills,3,14,3,3,0,23,7:2002:False:False,False,False
Chiefs,7,6,14,7,0,34,Broncos,3,3,14,14,3,37,7:2002:False:False,False,False
Rams,7,6,10,14,0,37,Seahawks,0,14,0,6,0,20,7:2002:False:False,False,False
Jets,3,7,7,3,0,20,Vikings,0,0,0,7,0,7,7:2002:False:False,False,False
Ravens,0,7,10,0,0,17,Jaguars,0,7,0,3,0,10,7:2002:False:False,False,False
Raiders,0,0,7,14,0,21,Chargers,0,7,7,7,6,27,7:2002:False:False,False,False
Browns,0,7,17,10,0,34,Texans,0,7,10,0,0,17,7:2002:False:False,False,False
Cardinals,3,3,0,0,3,9,Cowboys,0,0,6,0,0,6,7:2002:False:False,False,False
Packers,7,10,0,13,0,30,Redskins,3,3,3,0,0,9,7:2002:False:False,False,False
Eagles,3,7,3,7,0,20,Buccaneers,7,0,3,0,0,10,7:2002:False:False,False,False
Steelers,14,7,7,0,0,28,Colts,0,3,7,0,0,10,7:2002:False:False,False,False
Cowboys,0,0,7,7,0,14,Seahawks,0,7,0,10,0,17,8:2002:False:False,False,False
Ravens,0,3,8,7,0,18,Steelers,14,14,3,0,0,31,8:2002:False:False,False,False
Vikings,0,13,12,0,0,25,Bears,0,0,0,7,0,7,8:2002:False:False,False,False
Chiefs,3,3,7,7,0,20,Raiders,7,0,0,3,0,10,8:2002:False:False,False,False
Bills,7,7,10,0,0,24,Lions,0,14,0,3,0,17,8:2002:False:False,False,False
Jets,14,7,0,0,0,21,Browns,3,3,15,3,0,24,8:2002:False:False,False,False
Saints,10,0,15,10,0,35,Falcons,0,14,10,13,0,37,8:2002:False:False,False,False
Panthers,0,3,6,0,0,9,Buccaneers,3,0,0,9,0,12,8:2002:False:False,False,False
Bengals,7,7,3,7,0,24,Titans,0,6,14,10,0,30,8:2002:False:False,False,False
49ers,17,14,0,7,0,38,Cardinals,0,7,14,7,0,28,8:2002:False:False,False,False
Jaguars,0,9,3,7,0,19,Texans,0,7,3,11,0,21,8:2002:False:False,False,False
Patriots,0,7,3,6,0,16,Broncos,7,14,0,3,0,24,8:2002:False:False,False,False
Redskins,10,13,0,3,0,26,Colts,0,7,0,14,0,21,8:2002:False:False,False,False
Eagles,3,6,0,8,0,17,Giants,0,3,0,0,0,3,8:2002:False:False,False,False
Colts,0,0,0,15,0,15,Titans,10,10,3,0,0,23,9:2002:False:False,False,False
Texans,3,0,0,0,0,3,Bengals,10,14,0,14,0,38,9:2002:False:False,False,False
Lions,0,0,6,3,0,9,Cowboys,0,0,0,7,0,7,9:2002:False:False,False,False
Falcons,3,14,3,0,0,20,Ravens,3,7,7,0,0,17,9:2002:False:False,False,False
Buccaneers,14,10,7,7,0,38,Vikings,0,10,7,7,0,24,9:2002:False:False,False,False
Browns,7,7,0,6,0,20,Steelers,3,14,0,6,0,23,9:2002:False:False,False,False
Bears,0,13,0,0,0,13,Eagles,0,7,6,6,0,19,9:2002:False:False,False,False
Bills,0,7,0,0,0,7,Patriots,7,10,14,7,0,38,9:2002:False:False,False,False
Chargers,0,7,6,0,0,13,Jets,14,17,3,10,0,44,9:2002:False:False,False,False
Seahawks,0,3,0,0,0,3,Redskins,7,7,0,0,0,14,9:2002:False:False,False,False
Cardinals,0,7,0,7,0,14,Rams,7,10,0,10,0,27,9:2002:False:False,False,False
Raiders,7,6,0,7,0,20,49ers,10,0,3,7,3,23,9:2002:False:False,False,False
Giants,7,7,10,0,0,24,Jaguars,0,0,3,14,0,17,9:2002:False:False,False,False
Packers,0,14,10,0,0,24,Dolphins,0,0,0,10,0,10,9:2002:False:False,False,False
Rams,7,0,7,14,0,28,Chargers,7,10,7,0,0,24,10:2002:False:False,False,False
Ravens,7,17,7,7,0,38,Bengals,7,7,3,10,0,27,10:2002:False:False,False,False
Packers,3,27,10,0,0,40,Lions,7,0,0,7,0,14,10:2002:False:False,False,False
Steelers,3,14,14,3,0,34,Falcons,0,7,10,17,0,34,10:2002:False:False,False,False
Titans,7,3,7,0,0,17,Texans,0,3,0,7,0,10,10:2002:False:False,False,False
Vikings,0,3,3,14,0,20,Giants,7,6,6,8,0,27,10:2002:False:False,False,False
Panthers,0,7,10,7,0,24,Saints,6,7,7,14,0,34,10:2002:False:False,False,False
Eagles,3,3,0,7,0,13,Colts,14,0,14,7,0,35,10:2002:False:False,False,False
Cardinals,3,3,0,0,0,6,Seahawks,10,17,0,0,0,27,10:2002:False:False,False,False
Jaguars,0,10,13,3,0,26,Redskins,7,0,0,0,0,7,10:2002:False:False,False,False
Bears,0,6,21,3,0,30,Patriots,0,6,10,17,0,33,10:2002:False:False,False,False
49ers,3,14,0,0,0,17,Chiefs,3,7,0,3,0,13,10:2002:False:False,False,False
Jets,7,3,0,3,0,13,Dolphins,0,3,7,0,0,10,10:2002:False:False,False,False
Broncos,0,7,0,3,0,10,Raiders,10,11,6,7,0,34,10:2002:False:False,False,False
Giants,3,7,6,3,0,19,Redskins,0,10,7,0,0,17,11:2002:False:False,False,False
Chiefs,7,3,0,7,0,17,Bills,0,13,3,0,0,16,11:2002:False:False,False,False
Titans,7,7,14,3,0,31,Steelers,7,0,0,16,0,23,11:2002:False:False,False,False
Colts,0,3,0,17,0,20,Cowboys,0,3,0,0,0,3,11:2002:False:False,False,False
Falcons,0,7,7,10,0,24,Saints,0,0,3,14,0,17,11:2002:False:False,False,False
Texans,0,7,7,7,0,21,Jaguars,7,10,7,0,0,24,11:2002:False:False,False,False
Vikings,14,0,7,10,0,31,Packers,0,7,7,7,0,21,11:2002:False:False,False,False
Eagles,7,21,3,7,0,38,Cardinals,7,7,0,0,0,14,11:2002:False:False,False,False
Bengals,7,7,3,3,0,20,Browns,14,3,7,3,0,27,11:2002:False:False,False,False
Chargers,7,0,0,10,3,20,49ers,0,7,10,0,0,17,11:2002:False:False,False,False
Buccaneers,0,10,7,6,0,23,Panthers,7,3,0,0,0,10,11:2002:False:False,False,False
Lions,0,7,7,0,0,14,Jets,7,6,8,10,0,31,11:2002:False:False,False,False
Seahawks,0,0,6,3,0,9,Broncos,0,3,7,21,0,31,11:2002:False:False,False,False
Dolphins,7,10,3,6,0,26,Ravens,0,7,0,0,0,7,11:2002:False:False,False,False
Raiders,3,14,7,3,0,27,Patriots,3,3,7,7,0,20,11:2002:False:False,False,False
Rams,7,7,0,7,0,21,Bears,0,6,7,3,0,16,11:2002:False:False,False,False
Jets,3,14,7,7,0,31,Bills,3,0,10,0,0,13,12:2002:False:False,False,False
Ravens,10,0,3,0,0,13,Titans,0,6,0,6,0,12,12:2002:False:False,False,False
Steelers,14,3,3,9,0,29,Bengals,0,14,0,7,0,21,12:2002:False:False,False,False
Panthers,0,0,0,0,0,0,Falcons,14,14,13,0,0,41,12:2002:False:False,False,False
Dolphins,10,10,7,3,0,30,Chargers,3,0,0,0,0,3,12:2002:False:False,False,False
Patriots,7,14,0,3,0,24,Vikings,0,7,7,3,0,17,12:2002:False:False,False,False
Cowboys,0,7,7,7,0,21,Jaguars,0,5,0,14,0,19,12:2002:False:False,False,False
Redskins,0,7,13,0,0,20,Rams,7,3,0,7,0,17,12:2002:False:False,False,False
Bears,0,7,0,10,3,20,Lions,0,3,14,0,0,17,12:2002:False:False,False,False
Saints,3,3,6,3,0,15,Browns,7,7,7,3,0,24,12:2002:False:False,False,False
Cardinals,0,14,0,6,0,20,Raiders,14,7,17,3,0,41,12:2002:False:False,False,False
Seahawks,0,21,7,11,0,39,Chiefs,10,7,0,15,0,32,12:2002:False:False,False,False
Buccaneers,0,3,11,7,0,21,Packers,7,0,0,0,0,7,12:2002:False:False,False,False
Texans,0,5,8,3,0,16,Giants,0,7,0,7,0,14,12:2002:False:False,False,False
Broncos,0,6,7,7,0,20,Colts,3,0,14,3,3,23,12:2002:False:False,False,False
49ers,0,7,10,0,0,17,Eagles,0,21,14,3,0,38,12:2002:False:False,False,False
Lions,3,3,3,3,0,12,Patriots,10,7,0,3,0,20,13:2002:False:False,False,False
Cowboys,0,10,7,10,0,27,Redskins,0,14,6,0,0,20,13:2002:False:False,False,False
Bengals,6,10,7,0,0,23,Ravens,0,14,0,13,0,27,13:2002:False:False,False,False
Packers,3,3,10,14,0,30,Bears,7,7,0,6,0,20,13:2002:False:False,False,False
Browns,3,0,3,0,0,6,Panthers,7,0,0,6,0,13,13:2002:False:False,False,False
Bills,3,14,14,7,0,38,Dolphins,14,0,7,0,0,21,13:2002:False:False,False,False
Chiefs,14,21,7,7,0,49,Cardinals,0,0,0,0,0,0,13:2002:False:False,False,False
Jaguars,7,3,0,13,0,23,Steelers,6,10,3,6,0,25,13:2002:False:False,False,False
Vikings,7,7,7,3,0,24,Falcons,0,14,7,3,6,30,13:2002:False:False,False,False
Giants,3,7,10,9,0,29,Titans,0,14,0,15,3,32,13:2002:False:False,False,False
Chargers,0,24,0,3,3,30,Broncos,10,7,7,3,0,27,13:2002:False:False,False,False
Colts,10,3,0,6,0,19,Texans,0,0,0,3,0,3,13:2002:False:False,False,False
49ers,0,17,7,7,0,31,Seahawks,0,3,7,14,0,24,13:2002:False:False,False,False
Eagles,7,3,0,0,0,10,Rams,0,3,0,0,0,3,13:2002:False:False,False,False
Saints,0,6,14,3,0,23,Buccaneers,2,7,3,8,0,20,13:2002:False:False,False,False
Raiders,3,3,14,6,0,26,Jets,0,10,0,10,0,20,13:2002:False:False,False,False
Patriots,17,3,0,7,0,27,Bills,0,0,10,7,0,17,14:2002:False:False,False,False
Buccaneers,0,21,6,7,0,34,Falcons,0,3,0,7,0,10,14:2002:False:False,False,False
Chiefs,14,21,0,14,0,49,Rams,10,0,0,0,0,10,14:2002:False:False,False,False
Cowboys,6,0,7,14,0,27,49ers,0,7,3,21,0,31,14:2002:False:False,False,False
Redskins,0,3,11,7,0,21,Giants,3,14,7,3,0,27,14:2002:False:False,False,False
Titans,7,14,0,6,0,27,Colts,0,10,0,7,0,17,14:2002:False:False,False,False
Steelers,0,3,3,0,0,6,Texans,14,0,0,10,0,24,14:2002:False:False,False,False
Jaguars,7,0,7,6,0,20,Browns,0,0,14,7,0,21,14:2002:False:False,False,False
Panthers,9,7,21,15,0,52,Bengals,7,10,14,0,0,31,14:2002:False:False,False,False
Seahawks,6,0,7,7,0,20,Eagles,7,13,7,0,0,27,14:2002:False:False,False,False
Ravens,7,0,7,11,0,25,Saints,10,10,7,10,0,37,14:2002:False:False,False,False
Cardinals,7,7,3,3,3,23,Lions,14,3,3,0,0,20,14:2002:False:False,False,False
Chargers,0,7,0,0,0,7,Raiders,10,3,7,7,0,27,14:2002:False:False,False,False
Jets,0,6,3,10,0,19,Broncos,3,10,0,0,0,13,14:2002:False:False,False,False
Packers,0,6,7,13,0,26,Vikings,10,3,9,0,0,22,14:2002:False:False,False,False
Dolphins,7,7,7,6,0,27,Bears,0,0,3,6,0,9,14:2002:False:False,False,False
Steelers,7,6,7,10,0,30,Panthers,7,0,0,7,0,14,15:2002:False:False,False,False
Lions,0,10,3,7,0,20,Buccaneers,3,10,0,10,0,23,15:2002:False:False,False,False
Browns,13,3,0,7,0,23,Colts,0,0,14,14,0,28,15:2002:False:False,False,False
Eagles,7,10,14,3,0,34,Redskins,0,7,0,14,0,21,15:2002:False:False,False,False
Bengals,3,9,3,0,0,15,Jaguars,7,7,8,7,0,29,15:2002:False:False,False,False
Texans,0,7,7,5,0,19,Ravens,3,10,7,3,0,23,15:2002:False:False,False,False
Falcons,14,3,0,7,0,24,Seahawks,7,0,14,3,6,30,15:2002:False:False,False,False
Bills,7,6,0,7,0,20,Chargers,3,7,0,3,0,13,15:2002:False:False,False,False
Dolphins,10,7,3,3,0,23,Raiders,3,3,3,8,0,17,15:2002:False:False,False,False
Bears,0,10,7,3,0,20,Jets,0,0,10,3,0,13,15:2002:False:False,False,False
Saints,10,10,3,8,0,31,Vikings,14,10,0,8,0,32,15:2002:False:False,False,False
Broncos,14,0,14,3,0,31,Chiefs,0,0,14,10,0,24,15:2002:False:False,False,False
Giants,21,3,3,10,0,37,Cowboys,0,0,0,7,0,7,15:2002:False:False,False,False
49ers,0,6,8,0,0,14,Packers,3,0,14,3,0,20,15:2002:False:False,False,False
Rams,3,21,0,6,0,30,Cardinals,0,7,14,7,0,28,15:2002:False:False,False,False
Titans,0,14,7,3,0,24,Patriots,0,0,7,0,0,7,15:2002:False:False,False,False
Vikings,0,3,7,10,0,20,Dolphins,7,0,7,3,0,17,16:2002:False:False,False,False
Cardinals,0,7,0,7,0,14,49ers,7,3,7,0,0,17,16:2002:False:False,False,False
Cowboys,0,0,0,3,0,3,Eagles,7,10,0,10,0,27,16:2002:False:False,False,False
Colts,0,3,3,21,0,27,Giants,3,7,20,14,0,44,16:2002:False:False,False,False
Panthers,0,21,0,3,0,24,Bears,7,0,0,7,0,14,16:2002:False:False,False,False
Redskins,7,9,0,10,0,26,Texans,3,0,0,7,0,10,16:2002:False:False,False,False
Falcons,3,10,6,17,0,36,Lions,0,0,0,15,0,15,16:2002:False:False,False,False
Packers,0,3,0,7,0,10,Bills,0,0,0,0,0,0,16:2002:False:False,False,False
Chiefs,7,7,7,3,0,24,Chargers,3,3,9,7,0,22,16:2002:False:False,False,False
Bengals,7,0,0,13,0,20,Saints,10,3,0,0,0,13,16:2002:False:False,False,False
Jaguars,0,3,0,7,0,10,Titans,7,7,7,7,0,28,16:2002:False:False,False,False
Seahawks,3,10,10,7,0,30,Rams,0,3,7,0,0,10,16:2002:False:False,False,False
Ravens,3,7,3,0,0,13,Browns,7,0,0,7,0,14,16:2002:False:False,False,False
Raiders,14,7,0,7,0,28,Broncos,0,3,7,6,0,16,16:2002:False:False,False,False
Patriots,7,3,7,0,0,17,Jets,14,3,3,10,0,30,16:2002:False:False,False,False
Buccaneers,0,0,0,7,0,7,Steelers,17,0,0,0,0,17,16:2002:False:False,False,False
Giants,0,0,0,7,3,10,Eagles,7,0,0,0,0,7,17:2002:False:False,False,False
Raiders,0,14,3,7,0,24,Chiefs,0,0,0,0,0,0,17:2002:False:False,False,False
Browns,3,7,0,14,0,24,Falcons,0,7,9,0,0,16,17:2002:False:False,False,False
Saints,3,0,3,0,0,6,Panthers,0,7,3,0,0,10,17:2002:False:False,False,False
Texans,0,0,3,0,0,3,Titans,3,3,0,7,0,13,17:2002:False:False,False,False
Steelers,7,13,0,14,0,34,Ravens,7,7,10,7,0,31,17:2002:False:False,False,False
Lions,14,3,7,12,0,36,Vikings,14,14,7,3,0,38,17:2002:False:False,False,False
Patriots,0,10,3,11,3,27,Dolphins,7,14,0,3,0,24,17:2002:False:False,False,False
Redskins,0,7,10,3,0,20,Cowboys,0,7,0,7,0,14,17:2002:False:False,False,False
Bills,6,14,7,0,0,27,Bengals,0,3,0,6,0,9,17:2002:False:False,False,False
Colts,0,10,0,10,0,20,Jaguars,3,7,0,3,0,13,17:2002:False:False,False,False
Chargers,0,10,10,8,0,28,Seahawks,7,0,0,21,3,31,17:2002:False:False,False,False
Jets,0,14,14,14,0,42,Packers,0,10,0,7,0,17,17:2002:False:False,False,False
Broncos,3,6,7,21,0,37,Cardinals,0,7,0,0,0,7,17:2002:False:False,False,False
Bears,0,0,0,0,0,0,Buccaneers,0,6,0,9,0,15,17:2002:False:False,False,False
Rams,0,0,3,28,0,31,49ers,3,14,0,3,0,20,17:2002:False:False,False,False
Jets,7,17,10,7,0,41,Colts,0,0,0,0,0,0,18:2002:False:True,False,True
Packers,0,0,7,0,0,7,Falcons,14,10,3,0,0,27,18:2002:False:True,False,True
Steelers,0,7,7,22,0,36,Browns,7,10,7,9,0,33,18:2002:False:True,False,True
49ers,7,7,8,17,0,39,Giants,7,21,10,0,0,38,18:2002:False:True,False,True
Titans,14,0,14,3,3,34,Steelers,0,13,7,11,0,31,19:2002:False:True,False,True
Eagles,10,3,0,7,0,20,Falcons,0,6,0,0,0,6,19:2002:False:True,False,True
Buccaneers,7,21,3,0,0,31,49ers,3,3,0,0,0,6,19:2002:False:True,False,True
Raiders,3,7,7,13,0,30,Jets,3,7,0,0,0,10,19:2002:False:True,False,True
Eagles,7,3,0,0,0,10,Buccaneers,10,7,3,7,0,27,20:2002:False:True,False,True
Raiders,14,10,3,14,0,41,Titans,7,10,7,0,0,24,20:2002:False:True,False,True
Buccaneers,3,17,14,14,0,48,Raiders,3,0,6,12,0,21,21:2002:False:True,False,True
Patriots,10,3,7,6,0,26,Giants,0,6,0,0,0,6,1:2003:True:False,True,False
Dolphins,0,6,0,13,0,19,Buccaneers,7,6,7,0,0,20,1:2003:True:False,True,False
Raiders,0,7,0,0,0,7,Rams,0,0,0,6,0,6,1:2003:True:False,True,False
Lions,2,7,14,3,0,26,Steelers,0,6,0,7,0,13,1:2003:True:False,True,False
Vikings,7,0,7,0,0,14,Jaguars,0,13,0,3,0,16,1:2003:True:False,True,False
Titans,7,0,3,0,0,10,Browns,0,6,0,0,0,6,1:2003:True:False,True,False
Panthers,6,0,7,7,0,20,Redskins,0,0,0,0,0,0,1:2003:True:False,True,False
Ravens,7,0,0,12,0,19,Bills,7,3,3,7,0,20,1:2003:True:False,True,False
Falcons,14,7,0,0,0,21,Packers,3,7,17,0,0,27,1:2003:True:False,True,False
Bears,3,7,7,3,0,20,Colts,0,10,0,8,0,18,1:2003:True:False,True,False
Texans,3,3,6,0,0,12,Broncos,7,3,3,7,0,20,1:2003:True:False,True,False
Chiefs,0,6,0,0,0,6,49ers,0,7,7,10,0,24,1:2003:True:False,True,False
Seahawks,7,7,0,6,0,20,Chargers,0,0,0,7,0,7,1:2003:True:False,True,False
Cardinals,6,0,7,0,0,13,Cowboys,0,0,0,0,0,0,1:2003:True:False,True,False
Jets,7,0,0,21,0,28,Bengals,0,0,0,13,0,13,1:2003:True:False,True,False
Saints,3,0,0,14,0,17,Eagles,10,10,7,0,0,27,1:2003:True:False,True,False
49ers,0,7,0,7,0,14,Raiders,0,0,7,3,0,10,2:2003:True:False,True,False
Colts,7,7,7,0,0,21,Seahawks,0,0,0,7,0,7,2:2003:True:False,True,False
Jaguars,0,10,3,14,0,27,Dolphins,7,6,3,7,0,23,2:2003:True:False,True,False
Cowboys,0,17,7,10,0,34,Texans,3,0,3,0,0,6,2:2003:True:False,True,False
Browns,14,7,7,3,0,31,Packers,7,10,14,7,0,38,2:2003:True:False,True,False
Giants,3,7,0,0,0,10,Panthers,0,13,7,0,0,20,2:2003:True:False,True,False
Steelers,0,13,0,3,0,16,Eagles,7,14,0,0,0,21,2:2003:True:False,True,False
Bengals,3,6,14,0,0,23,Lions,0,3,0,7,0,10,2:2003:True:False,True,False
Redskins,0,7,3,3,0,13,Patriots,13,0,7,0,0,20,2:2003:True:False,True,False
Jets,0,7,3,7,0,17,Saints,0,3,6,13,0,22,2:2003:True:False,True,False
Falcons,0,3,0,7,0,10,Ravens,3,0,10,0,0,13,2:2003:True:False,True,False
Titans,7,17,10,3,0,37,Bills,0,10,7,7,0,24,2:2003:True:False,True,False
Bears,0,3,7,0,0,10,Broncos,3,0,0,12,0,15,2:2003:True:False,True,False
Chiefs,3,13,3,7,0,26,Vikings,7,3,0,6,0,16,2:2003:True:False,True,False
Chargers,3,0,0,7,0,10,Cardinals,0,3,10,3,0,16,2:2003:True:False,True,False
Rams,3,13,7,3,0,26,Buccaneers,0,0,8,8,0,16,2:2003:True:False,True,False
Steelers,0,7,0,8,0,15,Cowboys,0,7,7,0,0,14,3:2003:True:False,True,False
Eagles,0,3,0,9,0,12,Patriots,10,7,7,0,0,24,3:2003:True:False,True,False
Dolphins,7,3,14,6,0,30,Falcons,0,7,0,14,0,21,3:2003:True:False,True,False
Raiders,0,3,3,0,0,6,Vikings,7,7,7,0,0,21,3:2003:True:False,True,False
Cardinals,10,7,0,10,0,27,Bears,3,7,7,0,0,17,3:2003:True:False,True,False
Bills,14,0,0,14,0,28,Rams,0,14,10,0,0,24,3:2003:True:False,True,False
Bengals,0,7,0,8,0,15,Titans,3,10,3,7,0,23,3:2003:True:False,True,False
Lions,3,10,18,7,0,38,Browns,7,3,7,0,0,17,3:2003:True:False,True,False
Giants,7,7,0,0,0,14,Jets,0,3,3,9,0,15,3:2003:True:False,True,False
Redskins,3,14,0,7,0,24,Ravens,0,3,0,0,0,3,3:2003:True:False,True,False
Buccaneers,0,3,7,0,0,10,Jaguars,3,3,0,0,0,6,3:2003:True:False,True,False
Packers,0,0,7,0,0,7,Panthers,0,0,6,14,0,20,3:2003:True:False,True,False
Texans,10,0,0,7,0,17,Chargers,0,13,0,6,0,19,3:2003:True:False,True,False
49ers,0,20,0,7,0,27,Saints,3,6,3,0,0,12,3:2003:True:False,True,False
Seahawks,3,10,15,14,0,42,Chiefs,7,14,10,0,0,31,3:2003:True:False,True,False
Broncos,10,3,0,10,0,23,Colts,0,14,7,7,0,28,3:2003:True:False,True,False
Patriots,0,10,7,21,0,38,Bears,7,3,13,0,0,23,4:2003:True:False,True,False
Eagles,0,9,0,0,0,9,Jets,7,10,0,0,0,17,4:2003:True:False,True,False
Bills,14,0,0,8,0,22,Lions,0,13,3,0,0,16,4:2003:True:False,True,False
Packers,0,3,0,0,0,3,Titans,7,10,7,3,0,27,4:2003:True:False,True,False
Jaguars,7,7,0,3,0,17,Redskins,0,3,3,9,0,15,4:2003:True:False,True,False
Vikings,3,10,7,7,0,27,Cardinals,3,7,14,7,0,31,4:2003:True:False,True,False
Saints,0,7,3,0,0,10,Dolphins,7,17,0,0,0,24,4:2003:True:False,True,False
Cowboys,24,7,14,7,0,52,Raiders,0,7,6,0,0,13,4:2003:True:False,True,False
Buccaneers,7,20,0,7,0,34,Texans,0,0,3,0,0,3,4:2003:True:False,True,False
Browns,3,14,0,3,0,20,Falcons,0,9,0,0,0,9,4:2003:True:False,True,False
Ravens,10,7,0,7,0,24,Giants,0,20,3,7,0,30,4:2003:True:False,True,False
Rams,0,6,0,0,0,6,Chiefs,7,0,10,5,0,22,4:2003:True:False,True,False
Colts,7,0,7,7,0,21,Bengals,7,7,0,6,0,20,4:2003:True:False,True,False
Panthers,0,7,7,7,0,21,Steelers,7,7,0,0,0,14,4:2003:True:False,True,False
Chargers,10,0,7,7,0,24,49ers,0,3,0,0,0,3,4:2003:True:False,True,False
Broncos,3,0,14,3,0,20,Seahawks,0,3,0,0,0,3,4:2003:True:False,True,False
Redskins,3,10,0,3,0,16,Jets,7,0,3,3,0,13,1:2003:False:False,False,False
Packers,0,3,8,14,0,25,Vikings,10,10,7,3,0,30,1:2003:False:False,False,False
Giants,7,3,13,0,0,23,Rams,3,3,0,7,0,13,1:2003:False:False,False,False
Bills,7,14,0,10,0,31,Patriots,0,0,0,0,0,0,1:2003:False:False,False,False
Chiefs,14,10,3,0,0,27,Chargers,0,0,7,7,0,14,1:2003:False:False,False,False
Panthers,0,0,7,17,0,24,Jaguars,0,14,3,6,0,23,1:2003:False:False,False,False
Dolphins,0,14,0,6,0,20,Texans,3,3,9,6,0,21,1:2003:False:False,False,False
Steelers,6,7,14,7,0,34,Ravens,0,0,7,8,0,15,1:2003:False:False,False,False
Browns,3,0,0,3,0,6,Colts,0,3,3,3,0,9,1:2003:False:False,False,False
Lions,7,7,14,14,0,42,Cardinals,7,7,10,0,0,24,1:2003:False:False,False,False
Bengals,0,3,0,7,0,10,Broncos,3,17,7,3,0,30,1:2003:False:False,False,False
Cowboys,7,0,0,6,0,13,Falcons,3,0,14,10,0,27,1:2003:False:False,False,False
Seahawks,0,21,3,3,0,27,Saints,3,0,0,7,0,10,1:2003:False:False,False,False
49ers,10,23,6,10,0,49,Bears,0,7,0,0,0,7,1:2003:False:False,False,False
Titans,6,6,3,10,0,25,Raiders,3,7,0,10,0,20,1:2003:False:False,False,False
Eagles,0,0,0,0,0,0,Buccaneers,0,3,7,7,0,17,1:2003:False:False,False,False
Packers,14,3,7,7,0,31,Lions,0,6,0,0,0,6,2:2003:False:False,False,False
Saints,7,0,10,14,0,31,Texans,0,10,0,0,0,10,2:2003:False:False,False,False
Jets,3,0,0,7,0,10,Dolphins,7,14,0,0,0,21,2:2003:False:False,False,False
Chiefs,7,20,7,7,0,41,Steelers,17,3,0,0,0,20,2:2003:False:False,False,False
Rams,7,0,7,10,3,27,49ers,7,3,7,7,0,24,2:2003:False:False,False,False
Colts,3,14,3,13,0,33,Titans,0,7,0,0,0,7,2:2003:False:False,False,False
Falcons,3,21,0,7,0,31,Redskins,0,17,9,7,0,33,2:2003:False:False,False,False
Jaguars,0,7,3,7,0,17,Bills,14,7,14,3,0,38,2:2003:False:False,False,False
Ravens,10,6,0,17,0,33,Browns,0,3,10,0,0,13,2:2003:False:False,False,False
Cardinals,0,0,0,0,0,0,Seahawks,7,17,7,7,0,38,2:2003:False:False,False,False
Buccaneers,0,0,3,6,0,9,Panthers,3,3,3,0,3,12,2:2003:False:False,False,False
Raiders,10,0,3,10,0,23,Bengals,3,7,3,7,0,20,2:2003:False:False,False,False
Chargers,3,7,3,0,0,13,Broncos,14,10,10,3,0,37,2:2003:False:False,False,False
Eagles,0,7,0,3,0,10,Patriots,3,14,7,7,0,31,2:2003:False:False,False,False
Vikings,7,10,0,7,0,24,Bears,3,7,3,0,0,13,2:2003:False:False,False,False
Giants,7,0,7,18,0,32,Cowboys,7,13,6,6,3,35,2:2003:False:False,False,False
Lions,10,0,3,0,0,13,Vikings,0,16,7,0,0,23,3:2003:False:False,False,False
Texans,0,7,0,7,0,14,Chiefs,7,7,14,14,0,42,3:2003:False:False,False,False
Falcons,0,3,7,0,0,10,Buccaneers,3,14,14,0,0,31,3:2003:False:False,False,False
Bengals,0,0,3,7,0,10,Steelers,0,7,7,3,0,17,3:2003:False:False,False,False
Patriots,3,3,10,7,0,23,Jets,3,3,3,7,0,16,3:2003:False:False,False,False
Titans,10,3,7,7,0,27,Saints,2,3,0,7,0,12,3:2003:False:False,False,False
Colts,0,0,17,6,0,23,Jaguars,0,3,0,10,0,13,3:2003:False:False,False,False
Cardinals,7,3,3,7,0,20,Packers,0,10,0,3,0,13,3:2003:False:False,False,False
Redskins,3,0,7,11,0,21,Giants,7,14,0,0,3,24,3:2003:False:False,False,False
Seahawks,7,3,0,14,0,24,Rams,7,10,6,0,0,23,3:2003:False:False,False,False
Chargers,3,0,0,7,0,10,Ravens,7,3,14,0,0,24,3:2003:False:False,False,False
49ers,0,6,3,3,0,12,Browns,0,0,0,13,0,13,3:2003:False:False,False,False
Dolphins,0,7,3,7,0,17,Bills,0,0,0,7,0,7,3:2003:False:False,False,False
Broncos,21,3,7,0,0,31,Raiders,0,0,7,3,0,10,3:2003:False:False,False,False
Redskins,3,3,14,0,0,20,Patriots,3,0,7,7,0,17,4:2003:False:False,False,False
Steelers,3,10,0,0,0,13,Titans,0,16,7,7,0,30,4:2003:False:False,False,False
Bills,0,0,0,13,0,13,Eagles,10,3,3,7,0,23,4:2003:False:False,False,False
Browns,7,7,0,0,0,14,Bengals,7,7,7,0,0,21,4:2003:False:False,False,False
Rams,14,6,3,14,0,37,Cardinals,0,7,6,0,0,13,4:2003:False:False,False,False
Vikings,14,14,0,7,0,35,49ers,0,0,0,7,0,7,4:2003:False:False,False,False
Texans,7,7,3,7,0,24,Jaguars,3,7,10,0,0,20,4:2003:False:False,False,False
Ravens,0,0,3,7,0,10,Chiefs,0,3,7,7,0,17,4:2003:False:False,False,False
Raiders,7,7,0,17,3,34,Chargers,7,14,3,7,0,31,4:2003:False:False,False,False
Jets,3,0,3,0,0,6,Cowboys,0,14,0,3,0,17,4:2003:False:False,False,False
Panthers,7,10,0,6,0,23,Falcons,0,0,0,3,0,3,4:2003:False:False,False,False
Broncos,7,7,3,3,0,20,Lions,7,3,0,6,0,16,4:2003:False:False,False,False
Saints,0,10,3,8,0,21,Colts,14,10,24,7,0,55,4:2003:False:False,False,False
Bears,0,6,3,14,0,23,Packers,17,7,0,14,0,38,4:2003:False:False,False,False
Chiefs,7,3,7,7,0,24,Broncos,7,6,7,3,0,23,5:2003:False:False,False,False
Falcons,6,14,0,6,0,26,Vikings,0,12,15,12,0,39,5:2003:False:False,False,False
Bears,0,3,3,18,0,24,Raiders,6,12,0,3,0,21,5:2003:False:False,False,False
Patriots,7,0,14,17,0,38,Titans,6,7,3,14,0,30,5:2003:False:False,False,False
Packers,7,14,14,0,0,35,Seahawks,7,6,0,0,0,13,5:2003:False:False,False,False
Cowboys,7,10,7,0,0,24,Cardinals,7,0,0,0,0,7,5:2003:False:False,False,False
Bills,3,0,10,3,6,22,Bengals,0,6,0,10,0,16,5:2003:False:False,False,False
Giants,0,10,0,0,0,10,Dolphins,0,13,0,10,0,23,5:2003:False:False,False,False
Panthers,3,7,6,3,0,19,Saints,0,3,7,3,0,13,5:2003:False:False,False,False
Jaguars,7,3,10,7,0,27,Chargers,0,7,0,14,0,21,5:2003:False:False,False,False
49ers,10,7,7,0,0,24,Lions,0,10,0,7,0,17,5:2003:False:False,False,False
Eagles,3,10,7,7,0,27,Redskins,0,10,3,12,0,25,5:2003:False:False,False,False
Steelers,0,10,3,0,0,13,Browns,10,13,7,3,0,33,5:2003:False:False,False,False
Buccaneers,14,7,7,7,0,35,Colts,0,0,7,28,3,38,5:2003:False:False,False,False
Jaguars,0,3,7,0,0,10,Dolphins,10,0,0,14,0,24,6:2003:False:False,False,False
Cowboys,7,3,7,6,0,23,Eagles,0,7,7,7,0,21,6:2003:False:False,False,False
Browns,0,3,7,3,0,13,Raiders,7,0,0,0,0,7,6:2003:False:False,False,False
Redskins,3,7,3,0,0,13,Buccaneers,0,7,7,21,0,35,6:2003:False:False,False,False
Patriots,7,0,10,0,0,17,Giants,3,0,0,3,0,6,6:2003:False:False,False,False
Colts,0,13,0,7,0,20,Panthers,3,0,14,3,3,23,6:2003:False:False,False,False
Saints,3,3,7,7,0,20,Bears,0,3,0,10,0,13,6:2003:False:False,False,False
Packers,14,7,10,3,0,34,Chiefs,7,7,0,20,6,40,6:2003:False:False,False,False
Titans,14,7,3,14,0,38,Texans,0,3,7,7,0,17,6:2003:False:False,False,False
Cardinals,7,3,0,8,0,18,Ravens,3,13,7,3,0,26,6:2003:False:False,False,False
Jets,0,13,14,3,0,30,Bills,3,0,0,0,0,3,6:2003:False:False,False,False
Broncos,0,7,0,10,0,17,Steelers,3,3,0,8,0,14,6:2003:False:False,False,False
Seahawks,7,10,0,3,0,20,49ers,0,3,13,3,0,19,6:2003:False:False,False,False
Rams,3,7,9,17,0,36,Falcons,0,0,0,0,0,0,6:2003:False:False,False,False
Bengals,14,10,3,7,0,34,Ravens,7,0,3,16,0,26,7:2003:False:False,False,False
Dolphins,0,10,3,0,0,13,Patriots,3,3,7,0,6,19,7:2003:False:False,False,False
Giants,0,3,7,0,0,10,Eagles,7,0,0,7,0,14,7:2003:False:False,False,False
Falcons,14,0,3,0,0,17,Saints,14,21,3,7,0,45,7:2003:False:False,False,False
Browns,0,3,3,14,0,20,Chargers,6,7,10,3,0,26,7:2003:False:False,False,False
Lions,7,0,0,0,0,7,Cowboys,7,21,7,3,0,38,7:2003:False:False,False,False
Rams,14,7,7,6,0,34,Packers,3,7,7,7,0,24,7:2003:False:False,False,False
Vikings,7,7,14,0,0,28,Broncos,0,7,3,10,0,20,7:2003:False:False,False,False
Panthers,0,3,0,14,0,17,Titans,17,10,0,10,0,37,7:2003:False:False,False,False
Texans,7,7,0,0,0,14,Jets,0,7,3,9,0,19,7:2003:False:False,False,False
Seahawks,0,14,3,7,0,24,Bears,3,3,0,11,0,17,7:2003:False:False,False,False
Bills,3,7,7,7,0,24,Redskins,0,0,7,0,0,7,7:2003:False:False,False,False
49ers,7,14,0,3,0,24,Buccaneers,7,0,0,0,0,7,7:2003:False:False,False,False
Raiders,0,0,0,10,0,10,Chiefs,7,3,0,7,0,17,7:2003:False:False,False,False
Patriots,3,0,3,3,0,9,Browns,0,3,0,0,0,3,8:2003:False:False,False,False
Ravens,0,9,0,17,0,26,Broncos,3,0,3,0,0,6,8:2003:False:False,False,False
Vikings,3,7,7,0,0,17,Giants,7,6,3,13,0,29,8:2003:False:False,False,False
Buccaneers,0,10,6,0,0,16,Cowboys,0,0,0,0,0,0,8:2003:False:False,False,False
Bears,0,10,14,0,0,24,Lions,0,0,8,8,0,16,8:2003:False:False,False,False
Jaguars,0,10,0,7,0,17,Titans,10,10,7,3,0,30,8:2003:False:False,False,False
Saints,0,17,0,3,0,20,Panthers,3,7,3,7,3,23,8:2003:False:False,False,False
Bengals,7,10,3,7,0,27,Seahawks,7,10,7,0,0,24,8:2003:False:False,False,False
Steelers,7,7,7,0,0,21,Rams,7,10,10,6,0,33,8:2003:False:False,False,False
Cardinals,7,3,3,0,3,16,49ers,6,0,0,7,0,13,8:2003:False:False,False,False
Colts,3,14,10,3,0,30,Texans,0,14,0,7,0,21,8:2003:False:False,False,False
Eagles,7,7,0,10,0,24,Jets,10,0,7,0,0,17,8:2003:False:False,False,False
Chiefs,7,21,0,10,0,38,Bills,2,3,0,0,0,5,8:2003:False:False,False,False
Chargers,3,0,0,7,0,10,Dolphins,10,14,0,2,0,26,8:2003:False:False,False,False
Ravens,7,0,6,11,0,24,Jaguars,0,3,7,7,0,17,9:2003:False:False,False,False
Buccaneers,0,0,0,14,0,14,Saints,0,7,7,3,0,17,9:2003:False:False,False,False
Jets,7,0,7,14,0,28,Giants,0,13,7,8,3,31,9:2003:False:False,False,False
Bears,3,7,3,7,0,20,Chargers,0,0,0,7,0,7,9:2003:False:False,False,False
Lions,10,0,7,6,0,23,Raiders,0,3,7,3,0,13,9:2003:False:False,False,False
Texans,0,0,7,7,0,14,Panthers,7,0,3,0,0,10,9:2003:False:False,False,False
Dolphins,7,0,7,3,0,17,Colts,0,9,7,7,0,23,9:2003:False:False,False,False
Cardinals,7,3,7,0,0,17,Bengals,7,7,0,0,0,14,9:2003:False:False,False,False
Seahawks,3,3,3,14,0,23,Steelers,0,3,3,10,0,16,9:2003:False:False,False,False
Cowboys,0,7,7,7,0,21,Redskins,6,0,0,8,0,14,9:2003:False:False,False,False
Falcons,0,13,0,3,0,16,Eagles,10,0,3,10,0,23,9:2003:False:False,False,False
49ers,14,10,6,0,0,30,Rams,3,0,0,7,0,10,9:2003:False:False,False,False
Vikings,7,7,6,7,0,27,Packers,6,14,0,10,0,30,9:2003:False:False,False,False
Broncos,7,10,7,2,0,26,Patriots,7,6,7,10,0,30,9:2003:False:False,False,False
Lions,3,3,3,3,0,12,Bears,0,3,7,0,0,10,10:2003:False:False,False,False
Bengals,7,10,7,10,0,34,Texans,3,14,10,0,0,27,10:2003:False:False,False,False
Titans,14,7,7,3,0,31,Dolphins,0,0,0,7,0,7,10:2003:False:False,False,False
Panthers,10,0,10,7,0,27,Buccaneers,0,7,0,17,0,24,10:2003:False:False,False,False
Redskins,3,14,3,7,0,27,Seahawks,14,3,0,3,0,20,10:2003:False:False,False,False
Steelers,0,7,21,0,0,28,Cardinals,0,3,6,6,0,15,10:2003:False:False,False,False
Giants,0,7,0,0,0,7,Falcons,7,0,13,7,0,27,10:2003:False:False,False,False
Chiefs,14,13,7,7,0,41,Browns,3,14,3,0,0,20,10:2003:False:False,False,False
Jaguars,7,0,7,14,0,28,Colts,7,13,0,3,0,23,10:2003:False:False,False,False
Chargers,14,14,7,7,0,42,Vikings,7,7,0,14,0,28,10:2003:False:False,False,False
Cowboys,7,0,3,0,0,10,Bills,0,6,0,0,0,6,10:2003:False:False,False,False
Raiders,7,14,0,3,0,24,Jets,7,3,0,14,3,27,10:2003:False:False,False,False
Rams,14,7,0,12,0,33,Ravens,3,16,3,0,0,22,10:2003:False:False,False,False
Packers,0,7,0,7,0,14,Eagles,0,0,3,14,0,17,10:2003:False:False,False,False
Dolphins,0,3,3,0,3,9,Ravens,0,3,0,3,0,6,11:2003:False:False,False,False
Titans,3,7,0,0,0,10,Jaguars,0,0,0,3,0,3,11:2003:False:False,False,False
Eagles,7,7,7,7,0,28,Giants,3,0,0,7,0,10,11:2003:False:False,False,False
Bills,2,3,3,2,0,10,Texans,0,6,3,3,0,12,11:2003:False:False,False,False
Bears,0,14,0,7,0,21,Rams,3,0,7,13,0,23,11:2003:False:False,False,False
Browns,10,10,14,10,0,44,Cardinals,0,3,3,0,0,6,11:2003:False:False,False,False
Saints,0,3,7,10,3,23,Falcons,10,10,0,0,0,20,11:2003:False:False,False,False
Bengals,0,3,7,14,0,24,Chiefs,0,3,3,13,0,19,11:2003:False:False,False,False
Panthers,0,3,7,10,0,20,Redskins,0,3,0,14,0,17,11:2003:False:False,False,False
Colts,10,14,14,0,0,38,Jets,7,3,21,0,0,31,11:2003:False:False,False,False
Broncos,10,17,7,3,0,37,Chargers,0,0,0,8,0,8,11:2003:False:False,False,False
Seahawks,14,21,0,0,0,35,Lions,7,7,0,0,0,14,11:2003:False:False,False,False
Buccaneers,0,6,7,0,0,13,Packers,7,6,0,7,0,20,11:2003:False:False,False,False
Raiders,7,7,7,7,0,28,Vikings,0,3,7,8,0,18,11:2003:False:False,False,False
Patriots,3,6,0,3,0,12,Cowboys,0,0,0,0,0,0,11:2003:False:False,False,False
49ers,7,3,14,6,0,30,Steelers,0,0,7,7,0,14,11:2003:False:False,False,False
Bills,0,7,0,7,0,14,Colts,0,3,0,14,0,17,12:2003:False:False,False,False
Texans,3,0,7,10,0,20,Patriots,0,10,0,10,3,23,12:2003:False:False,False,False
Browns,3,3,0,0,0,6,Steelers,0,10,0,3,0,13,12:2003:False:False,False,False
Jets,3,0,0,10,0,13,Jaguars,0,3,0,7,0,10,12:2003:False:False,False,False
Ravens,0,3,21,17,3,44,Seahawks,0,17,17,7,0,41,12:2003:False:False,False,False
Cowboys,10,0,14,0,0,24,Panthers,3,7,7,3,0,20,12:2003:False:False,False,False
Vikings,7,0,0,17,0,24,Lions,0,0,7,7,0,14,12:2003:False:False,False,False
Eagles,10,10,3,10,0,33,Saints,0,7,7,6,0,20,12:2003:False:False,False,False
Packers,7,10,0,3,0,20,49ers,0,3,7,0,0,10,12:2003:False:False,False,False
Broncos,7,0,3,0,0,10,Bears,3,6,0,10,0,19,12:2003:False:False,False,False
Cardinals,0,10,7,10,0,27,Rams,14,3,7,3,3,30,12:2003:False:False,False,False
Chargers,7,6,0,14,0,27,Bengals,14,14,3,3,0,34,12:2003:False:False,False,False
Chiefs,14,7,3,3,0,27,Raiders,0,7,7,10,0,24,12:2003:False:False,False,False
Falcons,21,0,3,7,0,31,Titans,0,14,14,10,0,38,12:2003:False:False,False,False
Dolphins,7,3,0,14,0,24,Redskins,6,14,3,0,0,23,12:2003:False:False,False,False
Buccaneers,0,14,3,2,0,19,Giants,0,3,3,7,0,13,12:2003:False:False,False,False
Lions,10,3,0,9,0,22,Packers,0,7,7,0,0,14,13:2003:False:False,False,False
Cowboys,0,14,0,7,0,21,Dolphins,7,16,14,3,0,40,13:2003:False:False,False,False
Colts,0,10,14,10,0,34,Patriots,10,14,7,7,0,38,13:2003:False:False,False,False
Bears,7,0,0,21,0,28,Cardinals,3,0,0,0,0,3,13:2003:False:False,False,False
Giants,0,7,0,0,0,7,Bills,0,17,7,0,0,24,13:2003:False:False,False,False
Texans,0,3,14,0,0,17,Falcons,0,7,0,6,0,13,13:2003:False:False,False,False
Panthers,3,0,7,6,0,16,Eagles,7,3,3,12,0,25,13:2003:False:False,False,False
Ravens,7,17,0,20,0,44,49ers,3,3,0,0,0,6,13:2003:False:False,False,False
Rams,10,10,14,14,0,48,Vikings,7,10,0,0,0,17,13:2003:False:False,False,False
Steelers,0,3,7,10,0,20,Bengals,7,7,0,10,0,24,13:2003:False:False,False,False
Redskins,0,14,3,3,0,20,Saints,0,10,7,7,0,24,13:2003:False:False,False,False
Raiders,5,3,0,0,0,8,Broncos,0,14,0,8,0,22,13:2003:False:False,False,False
Chargers,0,7,10,7,0,24,Chiefs,7,14,0,7,0,28,13:2003:False:False,False,False
Seahawks,7,10,10,7,0,34,Browns,0,0,0,7,0,7,13:2003:False:False,False,False
Jaguars,0,10,0,7,0,17,Buccaneers,0,10,0,0,0,10,13:2003:False:False,False,False
Jets,7,3,7,7,0,24,Titans,7,0,3,7,0,17,13:2003:False:False,False,False
Titans,10,0,3,14,0,27,Colts,3,9,17,0,0,29,14:2003:False:False,False,False
Lions,0,0,0,7,0,7,Chargers,7,7,0,0,0,14,14:2003:False:False,False,False
Ravens,7,10,7,7,0,31,Bengals,3,7,3,0,0,13,14:2003:False:False,False,False
Jaguars,7,10,0,10,0,27,Texans,0,0,0,0,0,0,14:2003:False:False,False,False
Steelers,0,17,7,3,0,27,Raiders,7,0,0,0,0,7,14:2003:False:False,False,False
Vikings,0,13,7,14,0,34,Seahawks,0,0,7,0,0,7,14:2003:False:False,False,False
Saints,7,0,0,0,0,7,Buccaneers,0,14,0,0,0,14,14:2003:False:False,False,False
Giants,7,0,0,0,0,7,Redskins,3,7,7,3,0,20,14:2003:False:False,False,False
Packers,0,13,6,15,0,34,Bears,14,0,0,7,0,21,14:2003:False:False,False,False
Eagles,0,10,9,17,0,36,Cowboys,3,7,0,0,0,10,14:2003:False:False,False,False
49ers,14,20,9,7,0,50,Cardinals,0,0,7,7,0,14,14:2003:False:False,False,False
Broncos,7,10,14,14,0,45,Chiefs,7,14,0,6,0,27,14:2003:False:False,False,False
Patriots,3,0,0,9,0,12,Dolphins,0,0,0,0,0,0,14:2003:False:False,False,False
Bills,0,7,7,3,0,17,Jets,3,0,3,0,0,6,14:2003:False:False,False,False
Falcons,0,7,0,7,6,20,Panthers,0,7,7,0,0,14,14:2003:False:False,False,False
Browns,7,0,6,7,0,20,Rams,3,20,3,0,0,26,14:2003:False:False,False,False
Buccaneers,7,6,3,0,0,16,Texans,0,0,3,0,0,3,15:2003:False:False,False,False
Bears,3,7,3,0,0,13,Vikings,0,3,0,7,0,10,15:2003:False:False,False,False
Patriots,7,6,0,14,0,27,Jaguars,3,3,0,7,0,13,15:2003:False:False,False,False
Bengals,7,14,10,10,0,41,49ers,0,17,0,21,0,38,15:2003:False:False,False,False
Jets,3,3,0,0,0,6,Steelers,0,0,0,0,0,0,15:2003:False:False,False,False
Titans,3,3,8,14,0,28,Bills,0,10,7,9,0,26,15:2003:False:False,False,False
Chiefs,14,14,17,0,0,45,Lions,0,10,7,0,0,17,15:2003:False:False,False,False
Colts,14,10,14,0,0,38,Falcons,0,0,7,0,0,7,15:2003:False:False,False,False
Rams,14,7,0,6,0,27,Seahawks,2,10,3,7,0,22,15:2003:False:False,False,False
Raiders,10,7,0,3,0,20,Ravens,3,3,6,0,0,12,15:2003:False:False,False,False
Broncos,10,0,0,10,3,23,Browns,0,10,0,10,0,20,15:2003:False:False,False,False
Redskins,0,0,0,0,0,0,Cowboys,7,7,3,10,0,27,15:2003:False:False,False,False
Chargers,3,0,3,15,0,21,Packers,7,10,0,21,0,38,15:2003:False:False,False,False
Cardinals,7,7,0,3,0,17,Panthers,7,0,3,10,0,20,15:2003:False:False,False,False
Saints,10,14,14,7,0,45,Giants,0,7,0,0,0,7,15:2003:False:False,False,False
Dolphins,7,10,7,3,0,27,Eagles,14,10,0,10,0,34,15:2003:False:False,False,False
Buccaneers,0,7,0,21,0,28,Falcons,10,17,3,0,0,30,16:2003:False:False,False,False
Vikings,7,17,7,14,0,45,Chiefs,0,0,7,13,0,20,16:2003:False:False,False,False
Jets,7,3,0,6,0,16,Patriots,7,7,7,0,0,21,16:2003:False:False,False,False
Jaguars,0,17,3,0,0,20,Saints,3,7,3,6,0,19,16:2003:False:False,False,False
Bills,0,0,3,0,0,3,Dolphins,10,3,7,0,0,20,16:2003:False:False,False,False
Rams,7,10,3,7,0,27,Bengals,0,10,0,0,0,10,16:2003:False:False,False,False
Bears,10,0,14,3,0,27,Redskins,10,7,0,7,0,24,16:2003:False:False,False,False
Browns,0,0,0,0,0,0,Ravens,0,7,7,21,0,35,16:2003:False:False,False,False
Panthers,7,10,3,0,0,20,Lions,0,0,0,14,0,14,16:2003:False:False,False,False
Cowboys,10,3,3,3,0,19,Giants,3,0,0,0,0,3,16:2003:False:False,False,False
Texans,0,3,14,7,0,24,Titans,0,10,7,10,0,27,16:2003:False:False,False,False
Steelers,14,7,7,12,0,40,Chargers,0,10,7,7,0,24,16:2003:False:False,False,False
Eagles,0,14,7,7,0,28,49ers,7,7,3,11,3,31,16:2003:False:False,False,False
Seahawks,14,7,0,7,0,28,Cardinals,0,3,0,7,0,10,16:2003:False:False,False,False
Colts,7,10,0,0,0,17,Broncos,14,14,0,3,0,31,16:2003:False:False,False,False
Raiders,7,0,0,0,0,7,Packers,14,17,3,7,0,41,16:2003:False:False,False,False
Patriots,14,14,0,3,0,31,Bills,0,0,0,0,0,0,17:2003:False:False,False,False
49ers,0,14,3,0,0,17,Seahawks,0,14,7,3,0,24,17:2003:False:False,False,False
Redskins,0,7,0,0,0,7,Eagles,7,14,7,3,0,31,17:2003:False:False,False,False
Chiefs,0,14,7,10,0,31,Bears,0,0,3,0,0,3,17:2003:False:False,False,False
Saints,3,7,3,0,0,13,Cowboys,0,7,0,0,0,7,17:2003:False:False,False,False
Bengals,7,0,0,7,0,14,Browns,3,10,0,9,0,22,17:2003:False:False,False,False
Lions,3,7,17,3,0,30,Rams,0,20,0,0,0,20,17:2003:False:False,False,False
Dolphins,3,17,0,3,0,23,Jets,0,10,5,6,0,21,17:2003:False:False,False,False
Titans,3,13,10,7,0,33,Buccaneers,3,0,3,7,0,13,17:2003:False:False,False,False
Texans,0,10,7,0,0,17,Colts,0,3,0,17,0,20,17:2003:False:False,False,False
Falcons,14,7,0,0,0,21,Jaguars,7,0,7,0,0,14,17:2003:False:False,False,False
Giants,0,10,7,7,0,24,Panthers,17,13,7,0,0,37,17:2003:False:False,False,False
Cardinals,3,3,0,12,0,18,Vikings,0,0,7,10,0,17,17:2003:False:False,False,False
Chargers,7,7,0,7,0,21,Raiders,0,14,0,0,0,14,17:2003:False:False,False,False
Packers,7,3,7,14,0,31,Broncos,0,0,3,0,0,3,17:2003:False:False,False,False
Ravens,7,0,0,3,3,13,Steelers,0,0,10,0,0,10,17:2003:False:False,False,False
Ravens,7,3,0,7,0,17,Titans,7,0,7,6,0,20,18:2003:False:True,False,True
Panthers,6,10,7,6,0,29,Cowboys,0,3,0,7,0,10,18:2003:False:True,False,True
Packers,0,13,0,14,6,33,Seahawks,3,3,14,7,0,27,18:2003:False:True,False,True
Colts,14,17,10,0,0,41,Broncos,3,0,0,7,0,10,18:2003:False:True,False,True
Rams,3,6,3,11,0,23,Panthers,0,10,6,7,6,29,19:2003:False:True,False,True
Patriots,7,7,0,3,0,17,Titans,7,0,7,0,0,14,19:2003:False:True,False,True
Chiefs,3,7,14,7,0,31,Colts,14,7,10,7,0,38,19:2003:False:True,False,True
Eagles,0,7,0,10,3,20,Packers,14,0,0,3,0,17,19:2003:False:True,False,True
Patriots,7,8,6,3,0,24,Colts,0,0,7,7,0,14,20:2003:False:True,False,True
Eagles,0,3,0,0,0,3,Panthers,0,7,7,0,0,14,20:2003:False:True,False,True
Patriots,0,14,0,18,0,32,Panthers,0,10,0,19,0,29,21:2003:False:True,False,True
Rams,3,7,0,0,0,10,Bears,3,0,0,7,3,13,1:2004:True:False,True,False
Ravens,0,14,10,0,0,24,Falcons,0,0,0,0,0,0,1:2004:True:False,True,False
Giants,0,17,0,17,0,34,Chiefs,14,10,0,0,0,24,1:2004:True:False,True,False
Saints,7,3,7,6,0,23,Jets,3,3,7,0,0,13,1:2004:True:False,True,False
Patriots,7,3,7,7,0,24,Eagles,0,3,3,0,0,6,1:2004:True:False,True,False
Lions,7,3,7,10,0,27,Steelers,0,7,7,7,0,21,1:2004:True:False,True,False
Dolphins,3,6,0,7,0,16,Jaguars,0,0,5,0,0,5,1:2004:True:False,True,False
Vikings,0,13,7,3,0,23,Cardinals,3,0,3,0,0,6,1:2004:True:False,True,False
49ers,3,3,7,17,0,30,Raiders,3,10,7,13,0,33,1:2004:True:False,True,False
Texans,3,10,3,2,0,18,Cowboys,0,0,0,0,0,0,1:2004:True:False,True,False
Titans,7,10,7,0,0,24,Browns,0,3,0,0,0,3,1:2004:True:False,True,False
Redskins,0,3,7,10,0,20,Panthers,3,0,14,3,3,23,1:2004:True:False,True,False
Chargers,7,0,0,10,0,17,Colts,0,7,7,7,0,21,1:2004:True:False,True,False
Bills,3,7,0,6,0,16,Broncos,0,6,0,0,0,6,1:2004:True:False,True,False
Buccaneers,3,10,0,7,0,20,Bengals,3,3,0,0,0,6,1:2004:True:False,True,False
Packers,3,0,0,0,0,3,Seahawks,7,7,0,7,0,21,1:2004:True:False,True,False
Panthers,10,7,0,10,0,27,Giants,3,3,7,7,0,20,2:2004:True:False,True,False
Falcons,0,13,7,7,0,27,Vikings,14,3,7,0,0,24,2:2004:True:False,True,False
Jaguars,0,7,7,0,0,14,Buccaneers,0,0,3,3,0,6,2:2004:True:False,True,False
Eagles,10,7,3,6,0,26,Ravens,0,10,0,7,0,17,2:2004:True:False,True,False
Browns,7,7,0,3,0,17,Lions,7,0,3,0,0,10,2:2004:True:False,True,False
Bills,3,9,0,3,0,15,Titans,0,10,0,6,0,16,2:2004:True:False,True,False
Dolphins,0,0,0,0,0,0,Redskins,7,7,3,0,0,17,2:2004:True:False,True,False
Steelers,14,10,7,7,0,38,Texans,0,3,0,0,0,3,2:2004:True:False,True,False
Bengals,14,14,3,0,0,31,Patriots,0,3,0,0,0,3,2:2004:True:False,True,False
Packers,3,7,3,6,0,19,Saints,0,0,7,7,0,14,2:2004:True:False,True,False
Bears,3,7,7,3,0,20,49ers,3,7,0,3,0,13,2:2004:True:False,True,False
Colts,0,7,0,0,0,7,Jets,0,14,3,14,0,31,2:2004:True:False,True,False
Raiders,3,7,7,3,0,20,Cowboys,3,6,6,6,0,21,2:2004:True:False,True,False
Cardinals,3,3,0,7,0,13,Chargers,10,9,5,14,0,38,2:2004:True:False,True,False
Seahawks,0,3,0,0,0,3,Broncos,0,6,3,10,0,19,2:2004:True:False,True,False
Chiefs,7,17,0,0,0,24,Rams,0,0,7,0,0,7,2:2004:True:False,True,False
Eagles,7,7,7,0,0,21,Steelers,7,10,0,10,0,27,3:2004:True:False,True,False
Jets,0,17,0,0,0,17,Giants,7,0,3,0,0,10,3:2004:True:False,True,False
Rams,0,14,14,0,0,28,Redskins,3,0,0,0,0,3,3:2004:True:False,True,False
Jaguars,0,6,0,3,0,9,Packers,0,7,0,0,0,7,3:2004:True:False,True,False
Vikings,13,3,0,7,0,23,49ers,0,0,7,3,0,10,3:2004:True:False,True,False
Bears,0,3,10,0,0,13,Saints,3,7,0,7,0,17,3:2004:True:False,True,False
Broncos,0,13,6,12,0,31,Texans,7,7,3,0,0,17,3:2004:True:False,True,False
Chargers,0,0,7,13,0,20,Seahawks,10,13,3,0,0,26,3:2004:True:False,True,False
Buccaneers,0,3,7,7,0,17,Dolphins,0,3,7,0,0,10,3:2004:True:False,True,False
Falcons,10,17,7,3,0,37,Bengals,0,7,3,0,0,10,3:2004:True:False,True,False
Chiefs,6,0,13,0,0,19,Browns,0,7,0,14,0,21,3:2004:True:False,True,False
Ravens,3,0,7,7,0,17,Lions,3,3,0,0,0,6,3:2004:True:False,True,False
Panthers,0,10,0,10,0,20,Patriots,0,14,3,0,0,17,3:2004:True:False,True,False
Colts,10,10,7,3,0,30,Bills,0,10,0,7,0,17,3:2004:True:False,True,False
Cardinals,3,3,7,3,0,16,Raiders,0,3,7,7,0,17,3:2004:True:False,True,False
Cowboys,3,10,7,0,0,20,Titans,7,7,0,3,0,17,3:2004:True:False,True,False
Patriots,0,0,0,0,0,0,Jaguars,0,0,3,28,0,31,4:2004:True:False,True,False
Steelers,0,7,6,0,0,13,Panthers,3,0,7,6,0,16,4:2004:True:False,True,False
Giants,3,0,7,7,0,17,Ravens,14,10,0,3,0,27,4:2004:True:False,True,False
Texans,0,3,3,3,0,9,Buccaneers,0,10,7,0,0,17,4:2004:True:False,True,False
Cowboys,7,3,14,0,0,24,Chiefs,0,14,0,6,0,20,4:2004:True:False,True,False
Lions,3,10,7,0,0,20,Bills,7,3,7,0,0,17,4:2004:True:False,True,False
Seahawks,0,14,3,6,0,23,Vikings,7,0,14,0,0,21,4:2004:True:False,True,False
Broncos,0,0,7,14,0,21,Cardinals,6,17,10,0,0,33,4:2004:True:False,True,False
Raiders,7,7,0,14,0,28,Rams,7,3,7,7,0,24,4:2004:True:False,True,False
49ers,6,9,0,0,0,15,Chargers,7,10,7,7,0,31,4:2004:True:False,True,False
Redskins,24,0,0,3,0,27,Falcons,0,0,0,0,0,0,4:2004:True:False,True,False
Jets,0,7,0,21,0,28,Eagles,0,10,10,7,0,27,4:2004:True:False,True,False
Bengals,0,7,6,3,0,16,Colts,10,3,0,0,0,13,4:2004:True:False,True,False
Saints,7,6,0,6,0,19,Dolphins,7,0,6,7,0,20,4:2004:True:False,True,False
Titans,14,3,7,3,0,27,Packers,0,7,0,0,0,7,4:2004:True:False,True,False
Browns,7,0,3,14,0,24,Bears,3,7,0,0,0,10,4:2004:True:False,True,False
Patriots,3,10,14,0,0,27,Colts,0,17,0,7,0,24,1:2004:False:False,False,False
Dolphins,0,0,0,7,0,7,Titans,0,7,7,3,0,17,1:2004:False:False,False,False
Saints,0,7,0,0,0,7,Seahawks,0,14,7,0,0,21,1:2004:False:False,False,False
Redskins,7,3,0,6,0,16,Buccaneers,0,3,7,0,0,10,1:2004:False:False,False,False
Rams,0,6,3,8,0,17,Cardinals,0,3,7,0,0,10,1:2004:False:False,False,False
Bills,7,0,0,3,0,10,Jaguars,0,3,3,7,0,13,1:2004:False:False,False,False
Bears,7,0,0,9,0,16,Lions,0,3,10,7,0,20,1:2004:False:False,False,False
Browns,0,3,7,10,0,20,Ravens,0,0,3,0,0,3,1:2004:False:False,False,False
Texans,3,10,7,0,0,20,Chargers,3,7,10,7,0,27,1:2004:False:False,False,False
Jets,14,0,10,7,0,31,Bengals,7,3,7,7,0,24,1:2004:False:False,False,False
Steelers,7,7,7,3,0,24,Raiders,0,7,3,11,0,21,1:2004:False:False,False,False
Vikings,0,14,14,7,0,35,Cowboys,3,7,7,0,0,17,1:2004:False:False,False,False
Eagles,14,10,7,0,0,31,Giants,7,3,0,7,0,17,1:2004:False:False,False,False
49ers,0,3,3,13,0,19,Falcons,7,7,0,7,0,21,1:2004:False:False,False,False
Broncos,3,14,7,10,0,34,Chiefs,7,0,17,0,0,24,1:2004:False:False,False,False
Panthers,0,7,0,7,0,14,Packers,3,7,14,0,0,24,1:2004:False:False,False,False
Falcons,7,10,0,17,0,34,Rams,0,7,10,0,0,17,2:2004:False:False,False,False
Packers,3,0,7,0,0,10,Bears,0,14,7,0,0,21,2:2004:False:False,False,False
Jaguars,0,7,0,0,0,7,Broncos,0,6,0,0,0,6,2:2004:False:False,False,False
Chiefs,3,7,7,0,0,17,Panthers,7,0,7,14,0,28,2:2004:False:False,False,False
Saints,10,10,3,7,0,30,49ers,3,14,3,7,0,27,2:2004:False:False,False,False
Giants,0,20,0,0,0,20,Redskins,7,0,0,7,0,14,2:2004:False:False,False,False
Titans,7,3,7,0,0,17,Colts,3,0,7,21,0,31,2:2004:False:False,False,False
Ravens,7,6,7,10,0,30,Steelers,0,0,0,13,0,13,2:2004:False:False,False,False
Lions,0,7,14,7,0,28,Texans,0,3,7,6,0,16,2:2004:False:False,False,False
Buccaneers,0,3,0,3,0,6,Seahawks,3,7,0,0,0,10,2:2004:False:False,False,False
Cowboys,7,3,7,2,0,19,Browns,0,9,0,3,0,12,2:2004:False:False,False,False
Raiders,0,7,3,3,0,13,Bills,0,3,0,7,0,10,2:2004:False:False,False,False
Chargers,0,7,7,14,0,28,Jets,14,3,10,7,0,34,2:2004:False:False,False,False
Cardinals,0,6,6,0,0,12,Patriots,7,7,3,6,0,23,2:2004:False:False,False,False
Bengals,0,0,13,3,0,16,Dolphins,0,3,0,10,0,13,2:2004:False:False,False,False
Eagles,7,3,7,10,0,27,Vikings,3,3,3,7,0,16,2:2004:False:False,False,False
Bengals,0,3,3,3,0,9,Ravens,10,7,0,6,0,23,3:2004:False:False,False,False
Lions,0,7,0,6,0,13,Eagles,14,7,6,3,0,30,3:2004:False:False,False,False
Chiefs,7,0,7,7,0,21,Texans,0,6,8,10,0,24,3:2004:False:False,False,False
Vikings,0,10,7,10,0,27,Bears,3,3,0,16,0,22,3:2004:False:False,False,False
Falcons,3,3,0,0,0,6,Cardinals,0,0,0,3,0,3,3:2004:False:False,False,False
Giants,7,3,7,10,0,27,Browns,0,0,0,10,0,10,3:2004:False:False,False,False
Titans,0,6,0,6,0,12,Jaguars,0,0,7,8,0,15,3:2004:False:False,False,False
Rams,7,3,0,15,0,25,Saints,0,13,3,9,3,28,3:2004:False:False,False,False
Broncos,7,6,7,3,0,23,Chargers,3,0,7,3,0,13,3:2004:False:False,False,False
Colts,21,14,0,10,0,45,Packers,14,3,7,7,0,31,3:2004:False:False,False,False
Seahawks,17,7,10,0,0,34,49ers,0,0,0,0,0,0,3:2004:False:False,False,False
Raiders,3,10,17,0,0,30,Buccaneers,3,3,0,14,0,20,3:2004:False:False,False,False
Dolphins,0,0,0,3,0,3,Steelers,3,0,3,7,0,13,3:2004:False:False,False,False
Redskins,0,3,7,8,0,18,Cowboys,7,0,7,7,0,21,3:2004:False:False,False,False
Texans,3,14,3,10,0,30,Raiders,3,14,0,0,0,17,4:2004:False:False,False,False
Jaguars,0,3,3,11,0,17,Colts,7,3,7,7,0,24,4:2004:False:False,False,False
Steelers,7,7,0,14,0,28,Bengals,7,3,7,0,0,17,4:2004:False:False,False,False
Bears,0,3,0,6,0,9,Eagles,3,13,3,0,0,19,4:2004:False:False,False,False
Bills,10,7,0,0,0,17,Patriots,10,7,0,14,0,31,4:2004:False:False,False,False
Browns,3,0,7,7,0,17,Redskins,3,7,0,3,0,13,4:2004:False:False,False,False
Packers,0,0,7,0,0,7,Giants,0,0,7,7,0,14,4:2004:False:False,False,False
Panthers,7,3,0,0,0,10,Falcons,10,3,0,14,0,27,4:2004:False:False,False,False
Cardinals,7,7,3,17,0,34,Saints,0,3,7,0,0,10,4:2004:False:False,False,False
Buccaneers,0,10,3,0,0,13,Broncos,7,6,0,3,0,16,4:2004:False:False,False,False
Chargers,7,14,3,14,0,38,Titans,0,7,0,10,0,17,4:2004:False:False,False,False
Dolphins,0,9,0,0,0,9,Jets,7,3,7,0,0,17,4:2004:False:False,False,False
49ers,0,0,0,14,0,14,Rams,14,10,0,0,0,24,4:2004:False:False,False,False
Ravens,3,14,0,7,0,24,Chiefs,10,7,3,7,0,27,4:2004:False:False,False,False
Cowboys,0,10,0,0,0,10,Giants,3,3,7,13,0,26,5:2004:False:False,False,False
Texans,0,0,7,21,0,28,Vikings,0,14,7,7,6,34,5:2004:False:False,False,False
Colts,7,14,0,14,0,35,Raiders,0,7,0,7,0,14,5:2004:False:False,False,False
Patriots,7,10,7,0,0,24,Dolphins,0,7,3,0,0,10,5:2004:False:False,False,False
Saints,0,7,7,3,0,17,Buccaneers,3,10,7,0,0,20,5:2004:False:False,False,False
Falcons,0,7,0,3,0,10,Lions,0,14,3,0,0,17,5:2004:False:False,False,False
Steelers,14,13,7,0,0,34,Browns,10,3,3,7,0,23,5:2004:False:False,False,False
Chargers,14,7,6,7,0,34,Jaguars,0,7,0,14,0,21,5:2004:False:False,False,False
Jets,0,10,3,3,0,16,Bills,0,0,0,14,0,14,5:2004:False:False,False,False
Broncos,6,7,0,7,0,20,Panthers,0,10,7,0,0,17,5:2004:False:False,False,False
49ers,0,6,6,16,3,31,Cardinals,0,14,0,14,0,28,5:2004:False:False,False,False
Seahawks,7,17,0,3,0,27,Rams,0,7,3,17,6,33,5:2004:False:False,False,False
Redskins,0,10,0,0,0,10,Ravens,0,0,14,3,0,17,5:2004:False:False,False,False
Packers,3,10,0,14,0,27,Titans,17,10,7,14,0,48,5:2004:False:False,False,False
Bills,7,0,10,3,0,20,Dolphins,0,10,0,3,0,13,6:2004:False:False,False,False
Bears,0,7,0,3,0,10,Redskins,3,7,0,3,0,13,6:2004:False:False,False,False
Browns,7,14,3,10,0,34,Bengals,0,17,0,0,0,17,6:2004:False:False,False,False
Lions,7,3,0,0,0,10,Packers,7,10,14,7,0,38,6:2004:False:False,False,False
Jaguars,7,7,0,8,0,22,Chiefs,3,0,7,6,0,16,6:2004:False:False,False,False
Jets,0,3,6,13,0,22,49ers,7,7,0,0,0,14,6:2004:False:False,False,False
Eagles,10,3,10,7,0,30,Panthers,0,0,0,8,0,8,6:2004:False:False,False,False
Titans,0,10,0,0,0,10,Texans,3,10,0,7,0,20,6:2004:False:False,False,False
Falcons,0,7,0,14,0,21,Chargers,0,14,3,3,0,20,6:2004:False:False,False,False
Patriots,10,10,0,10,0,30,Seahawks,0,6,3,11,0,20,6:2004:False:False,False,False
Raiders,3,0,0,0,0,3,Broncos,7,14,10,0,0,31,6:2004:False:False,False,False
Cowboys,7,3,10,0,0,20,Steelers,7,3,0,14,0,24,6:2004:False:False,False,False
Saints,0,14,7,10,0,31,Vikings,7,14,10,7,0,38,6:2004:False:False,False,False
Rams,7,7,7,7,0,28,Buccaneers,7,7,7,0,0,21,6:2004:False:False,False,False
Panthers,6,0,0,0,0,6,Chargers,0,0,10,7,0,17,7:2004:False:False,False,False
Browns,7,10,7,7,0,31,Eagles,14,7,0,10,3,34,7:2004:False:False,False,False
Colts,0,14,0,10,0,24,Jaguars,0,10,3,14,0,27,7:2004:False:False,False,False
Chiefs,14,21,7,14,0,56,Falcons,3,0,7,0,0,10,7:2004:False:False,False,False
Dolphins,7,7,0,17,0,31,Rams,0,7,0,7,0,14,7:2004:False:False,False,False
Giants,7,3,0,3,0,13,Lions,7,0,7,14,0,28,7:2004:False:False,False,False
Buccaneers,0,10,3,6,0,19,Bears,0,0,7,0,0,7,7:2004:False:False,False,False
Ravens,10,7,0,3,0,20,Bills,3,0,3,0,0,6,7:2004:False:False,False,False
Vikings,3,14,0,3,0,20,Titans,3,0,0,0,0,3,7:2004:False:False,False,False
Patriots,3,10,0,0,0,13,Jets,0,7,0,0,0,7,7:2004:False:False,False,False
Cardinals,7,6,3,9,0,25,Seahawks,0,3,7,7,0,17,7:2004:False:False,False,False
Packers,3,17,21,0,0,41,Cowboys,6,0,7,7,0,20,7:2004:False:False,False,False
Raiders,6,3,0,17,0,26,Saints,0,7,14,10,0,31,7:2004:False:False,False,False
Bengals,7,6,7,3,0,23,Broncos,0,7,3,0,0,10,7:2004:False:False,False,False
Cowboys,7,7,7,10,0,31,Lions,7,7,0,7,0,21,8:2004:False:False,False,False
Texans,7,3,0,10,0,20,Jaguars,0,3,0,3,0,6,8:2004:False:False,False,False
Chiefs,7,24,0,14,0,45,Colts,7,7,14,7,0,35,8:2004:False:False,False,False
Vikings,0,0,0,13,0,13,Giants,10,10,7,7,0,34,8:2004:False:False,False,False
Eagles,3,3,0,9,0,15,Ravens,3,0,0,7,0,10,8:2004:False:False,False,False
Redskins,0,7,0,7,0,14,Packers,3,14,3,8,0,28,8:2004:False:False,False,False
Bills,10,7,0,21,0,38,Cardinals,0,7,0,7,0,14,8:2004:False:False,False,False
Titans,0,13,14,0,0,27,Bengals,3,0,10,7,0,20,8:2004:False:False,False,False
Seahawks,7,7,3,6,0,23,Panthers,0,7,3,7,0,17,8:2004:False:False,False,False
Broncos,14,0,0,14,0,28,Falcons,3,17,7,14,0,41,8:2004:False:False,False,False
Steelers,21,3,10,0,0,34,Patriots,3,7,3,7,0,20,8:2004:False:False,False,False
Chargers,14,14,14,0,0,42,Raiders,0,7,7,0,0,14,8:2004:False:False,False,False
Bears,7,6,0,10,0,23,49ers,10,3,0,0,0,13,8:2004:False:False,False,False
Jets,7,10,14,10,0,41,Dolphins,0,7,0,7,0,14,8:2004:False:False,False,False
Panthers,0,7,7,10,0,24,Raiders,3,14,0,10,0,27,9:2004:False:False,False,False
Bengals,3,6,7,10,0,26,Cowboys,0,3,0,0,0,3,9:2004:False:False,False,False
Lions,0,3,0,7,0,10,Redskins,0,3,14,0,0,17,9:2004:False:False,False,False
Dolphins,9,3,0,11,0,23,Cardinals,3,0,7,14,0,24,9:2004:False:False,False,False
Steelers,14,7,3,3,0,27,Eagles,0,3,0,0,0,3,9:2004:False:False,False,False
Bills,7,3,7,5,0,22,Jets,0,10,0,7,0,17,9:2004:False:False,False,False
Buccaneers,7,14,7,6,0,34,Chiefs,7,17,7,0,0,31,9:2004:False:False,False,False
Chargers,14,6,16,7,0,43,Saints,0,7,0,10,0,17,9:2004:False:False,False,False
49ers,14,3,7,3,0,27,Seahawks,7,14,14,7,0,42,9:2004:False:False,False,False
Giants,14,0,0,7,0,21,Bears,0,20,0,8,0,28,9:2004:False:False,False,False
Broncos,7,17,7,0,0,31,Texans,0,7,0,6,0,13,9:2004:False:False,False,False
Rams,0,14,0,8,0,22,Patriots,6,13,14,7,0,40,9:2004:False:False,False,False
Ravens,3,9,0,15,0,27,Browns,10,0,0,3,0,13,9:2004:False:False,False,False
Colts,7,7,7,10,0,31,Vikings,0,6,8,14,0,28,9:2004:False:False,False,False
Titans,7,0,0,10,0,17,Bears,0,7,7,3,2,19,10:2004:False:False,False,False
Rams,14,3,3,3,0,23,Seahawks,0,6,6,0,0,12,10:2004:False:False,False,False
Jets,0,14,0,3,0,17,Ravens,0,7,3,7,3,20,10:2004:False:False,False,False
Jaguars,7,3,7,0,6,23,Lions,0,0,0,17,0,17,10:2004:False:False,False,False
Colts,7,14,21,7,0,49,Texans,0,0,7,7,0,14,10:2004:False:False,False,False
Browns,3,0,0,7,0,10,Steelers,7,7,0,10,0,24,10:2004:False:False,False,False
Saints,0,14,3,10,0,27,Chiefs,10,3,0,7,0,20,10:2004:False:False,False,False
Falcons,10,7,0,7,0,24,Buccaneers,0,7,7,0,0,14,10:2004:False:False,False,False
Redskins,0,0,0,10,0,10,Bengals,7,10,0,0,0,17,10:2004:False:False,False,False
49ers,10,7,3,7,0,27,Panthers,0,3,17,17,0,37,10:2004:False:False,False,False
Packers,7,17,0,10,0,34,Vikings,7,3,7,14,0,31,10:2004:False:False,False,False
Cardinals,0,10,7,0,0,17,Giants,7,7,0,0,0,14,10:2004:False:False,False,False
Patriots,3,17,3,6,0,29,Bills,0,0,6,0,0,6,10:2004:False:False,False,False
Cowboys,0,14,7,0,0,21,Eagles,7,28,7,7,0,49,10:2004:False:False,False,False
Bills,0,17,20,0,0,37,Rams,10,7,0,0,0,17,11:2004:False:False,False,False
Panthers,14,14,0,7,0,35,Cardinals,0,0,10,0,0,10,11:2004:False:False,False,False
Vikings,7,0,0,15,0,22,Lions,14,3,2,0,0,19,11:2004:False:False,False,False
Saints,0,13,0,0,0,13,Broncos,20,7,0,7,0,34,11:2004:False:False,False,False
Browns,0,7,0,0,0,7,Jets,0,0,3,7,0,10,11:2004:False:False,False,False
Ravens,0,0,14,16,0,30,Cowboys,3,0,0,7,0,10,11:2004:False:False,False,False
Bears,3,0,0,7,0,10,Colts,7,20,14,0,0,41,11:2004:False:False,False,False
Bengals,7,7,0,0,0,14,Steelers,3,7,7,2,0,19,11:2004:False:False,False,False
Jaguars,0,6,7,2,0,15,Titans,3,7,0,8,0,18,11:2004:False:False,False,False
Buccaneers,7,14,7,7,0,35,49ers,0,0,3,0,0,3,11:2004:False:False,False,False
Raiders,0,7,7,3,0,17,Chargers,6,7,3,7,0,23,11:2004:False:False,False,False
Seahawks,10,7,0,7,0,24,Dolphins,7,0,7,3,0,17,11:2004:False:False,False,False
Eagles,7,0,7,14,0,28,Redskins,3,3,0,0,0,6,11:2004:False:False,False,False
Giants,0,0,7,3,0,10,Falcons,7,7,0,0,0,14,11:2004:False:False,False,False
Texans,0,13,0,0,0,13,Packers,0,3,0,13,0,16,11:2004:False:False,False,False
Chiefs,10,0,3,6,0,19,Patriots,7,10,7,3,0,27,11:2004:False:False,False,False
Lions,6,3,0,0,0,9,Colts,13,14,14,0,0,41,12:2004:False:False,False,False
Cowboys,7,0,0,14,0,21,Bears,0,7,0,0,0,7,12:2004:False:False,False,False
Bengals,14,13,14,17,0,58,Browns,10,3,21,14,0,48,12:2004:False:False,False,False
Texans,3,7,14,7,0,31,Titans,14,7,0,0,0,21,12:2004:False:False,False,False
Chiefs,7,10,0,14,0,31,Chargers,7,7,3,17,0,34,12:2004:False:False,False,False
Vikings,3,10,7,7,0,27,Jaguars,0,13,0,3,0,16,12:2004:False:False,False,False
Giants,3,3,0,0,0,6,Eagles,0,7,13,7,0,27,12:2004:False:False,False,False
Steelers,3,10,0,3,0,16,Redskins,0,0,7,0,0,7,12:2004:False:False,False,False
Panthers,7,0,7,7,0,21,Buccaneers,0,7,0,7,0,14,12:2004:False:False,False,False
Falcons,7,10,0,7,0,24,Saints,0,6,8,7,0,21,12:2004:False:False,False,False
49ers,0,3,0,14,0,17,Dolphins,7,0,0,17,0,24,12:2004:False:False,False,False
Seahawks,0,3,0,6,0,9,Bills,7,10,7,14,0,38,12:2004:False:False,False,False
Patriots,0,3,6,15,0,24,Ravens,0,3,0,0,0,3,12:2004:False:False,False,False
Cardinals,0,3,0,0,0,3,Jets,0,3,10,0,0,13,12:2004:False:False,False,False
Broncos,0,10,0,14,0,24,Raiders,0,7,6,12,0,25,12:2004:False:False,False,False
Packers,7,14,7,17,0,45,Rams,0,10,0,7,0,17,12:2004:False:False,False,False
Browns,0,7,0,8,0,15,Patriots,14,7,21,0,0,42,13:2004:False:False,False,False
Lions,7,7,6,6,0,26,Cardinals,3,9,0,0,0,12,13:2004:False:False,False,False
Colts,17,14,10,10,0,51,Titans,24,0,0,0,0,24,13:2004:False:False,False,False
Dolphins,21,3,0,8,0,32,Bills,14,7,7,14,0,42,13:2004:False:False,False,False
Saints,0,7,7,7,0,21,Panthers,13,13,0,6,0,32,13:2004:False:False,False,False
Jets,3,3,7,16,0,29,Texans,0,7,0,0,0,7,13:2004:False:False,False,False
Rams,3,10,0,3,0,16,49ers,3,0,3,0,0,6,13:2004:False:False,False,False
Buccaneers,7,6,7,7,0,27,Falcons,0,0,0,0,0,0,13:2004:False:False,False,False
Ravens,3,3,14,6,0,26,Bengals,0,3,0,24,0,27,13:2004:False:False,False,False
Bears,7,10,0,7,0,24,Vikings,7,7,0,0,0,14,13:2004:False:False,False,False
Chargers,7,10,3,0,0,20,Broncos,0,7,0,10,0,17,13:2004:False:False,False,False
Raiders,6,14,0,7,0,27,Chiefs,7,3,14,10,0,34,13:2004:False:False,False,False
Eagles,7,28,9,3,0,47,Packers,0,3,0,14,0,17,13:2004:False:False,False,False
Redskins,7,14,3,7,0,31,Giants,0,0,7,0,0,7,13:2004:False:False,False,False
Jaguars,7,0,6,3,0,16,Steelers,7,7,0,3,0,17,13:2004:False:False,False,False
Seahawks,14,0,3,22,0,39,Cowboys,3,16,10,14,0,43,13:2004:False:False,False,False
Bills,3,14,3,17,0,37,Browns,7,0,0,0,0,7,14:2004:False:False,False,False
Cowboys,10,0,3,0,0,13,Saints,0,10,3,14,0,27,14:2004:False:False,False,False
Falcons,0,21,7,7,0,35,Raiders,3,0,0,7,0,10,14:2004:False:False,False,False
Ravens,10,17,10,0,0,37,Giants,0,7,0,7,0,14,14:2004:False:False,False,False
Patriots,7,21,7,0,0,35,Bengals,0,14,7,7,0,28,14:2004:False:False,False,False
Vikings,10,10,3,0,0,23,Seahawks,7,14,3,3,0,27,14:2004:False:False,False,False
Jaguars,7,3,3,9,0,22,Bears,0,3,0,0,0,3,14:2004:False:False,False,False
Texans,0,7,7,0,0,14,Colts,14,0,3,6,0,23,14:2004:False:False,False,False
Broncos,0,14,3,3,0,20,Dolphins,7,7,3,0,0,17,14:2004:False:False,False,False
Steelers,3,0,0,14,0,17,Jets,0,0,3,3,0,6,14:2004:False:False,False,False
Chargers,0,14,7,10,0,31,Buccaneers,0,7,7,10,0,24,14:2004:False:False,False,False
Panthers,14,6,0,0,0,20,Rams,7,0,0,0,0,7,14:2004:False:False,False,False
Cardinals,0,3,7,18,0,28,49ers,7,14,7,0,3,31,14:2004:False:False,False,False
Packers,0,0,10,6,0,16,Lions,3,10,0,0,0,13,14:2004:False:False,False,False
Redskins,7,0,0,7,0,14,Eagles,7,0,10,0,0,17,14:2004:False:False,False,False
Titans,7,14,7,10,0,38,Chiefs,0,14,14,21,0,49,14:2004:False:False,False,False
Giants,14,0,10,6,0,30,Steelers,10,10,3,10,0,33,15:2004:False:False,False,False
49ers,7,2,0,7,0,16,Redskins,7,16,3,0,0,26,15:2004:False:False,False,False
Falcons,7,3,14,7,3,34,Panthers,0,10,0,21,0,31,15:2004:False:False,False,False
Bengals,7,3,0,7,0,17,Bills,14,13,0,6,0,33,15:2004:False:False,False,False
Jets,3,21,6,7,0,37,Seahawks,7,7,0,0,0,14,15:2004:False:False,False,False
Chiefs,14,14,7,10,0,45,Broncos,7,3,0,7,0,17,15:2004:False:False,False,False
Bears,0,0,2,3,0,5,Texans,0,7,0,17,0,24,15:2004:False:False,False,False
Eagles,0,6,0,6,0,12,Cowboys,0,7,0,0,0,7,15:2004:False:False,False,False
Lions,3,10,0,14,0,27,Vikings,7,7,0,14,0,28,15:2004:False:False,False,False
Browns,0,0,0,0,0,0,Chargers,7,7,7,0,0,21,15:2004:False:False,False,False
Buccaneers,7,0,7,3,0,17,Saints,7,0,0,14,0,21,15:2004:False:False,False,False
Cardinals,10,7,7,7,0,31,Rams,0,7,0,0,0,7,15:2004:False:False,False,False
Raiders,14,7,14,5,0,40,Titans,7,14,0,14,0,35,15:2004:False:False,False,False
Packers,0,10,7,8,0,25,Jaguars,7,7,7,7,0,28,15:2004:False:False,False,False
Colts,3,3,14,0,0,20,Ravens,0,3,0,7,0,10,15:2004:False:False,False,False
Dolphins,7,3,7,12,0,29,Patriots,7,7,7,7,0,28,15:2004:False:False,False,False
Vikings,0,21,0,10,0,31,Packers,0,17,7,10,0,34,16:2004:False:False,False,False
Chiefs,7,14,0,10,0,31,Raiders,7,14,3,6,0,30,16:2004:False:False,False,False
Titans,10,6,0,0,0,16,Broncos,17,7,3,10,0,37,16:2004:False:False,False,False
Colts,0,9,7,15,3,34,Chargers,7,10,7,7,0,31,16:2004:False:False,False,False
Steelers,7,3,7,3,0,20,Ravens,7,0,0,0,0,7,16:2004:False:False,False,False
Saints,5,7,14,0,0,26,Falcons,0,6,7,0,0,13,16:2004:False:False,False,False
Jaguars,0,0,0,0,0,0,Texans,7,7,0,7,0,21,16:2004:False:False,False,False
Lions,3,13,0,3,0,19,Bears,0,0,6,7,0,13,16:2004:False:False,False,False
Bengals,7,3,7,6,0,23,Giants,0,13,3,6,0,22,16:2004:False:False,False,False
49ers,0,0,0,7,0,7,Bills,0,17,10,14,0,41,16:2004:False:False,False,False
Jets,0,0,0,7,0,7,Patriots,0,13,3,7,0,23,16:2004:False:False,False,False
Buccaneers,7,0,7,6,0,20,Panthers,7,10,7,13,0,37,16:2004:False:False,False,False
Cowboys,0,6,0,7,0,13,Redskins,3,0,0,7,0,10,16:2004:False:False,False,False
Seahawks,0,10,7,7,0,24,Cardinals,7,0,0,14,0,21,16:2004:False:False,False,False
Dolphins,7,0,0,3,0,10,Browns,7,0,0,0,0,7,16:2004:False:False,False,False
Rams,7,3,7,3,0,20,Eagles,7,0,0,0,0,7,16:2004:False:False,False,False
Ravens,7,13,10,0,0,30,Dolphins,7,0,14,2,0,23,17:2004:False:False,False,False
Bills,7,3,7,7,0,24,Steelers,10,6,0,13,0,29,17:2004:False:False,False,False
Redskins,7,7,0,7,0,21,Vikings,0,3,7,8,0,18,17:2004:False:False,False,False
Titans,7,7,7,3,0,24,Lions,3,7,3,6,0,19,17:2004:False:False,False,False
Rams,0,14,7,8,3,32,Jets,3,7,16,3,0,29,17:2004:False:False,False,False
Eagles,0,3,0,7,0,10,Bengals,0,17,14,7,0,38,17:2004:False:False,False,False
Patriots,0,7,7,7,0,21,49ers,7,0,0,0,0,7,17:2004:False:False,False,False
Panthers,3,0,7,8,0,18,Saints,7,7,7,0,0,21,17:2004:False:False,False,False
Bears,7,0,7,0,0,14,Packers,7,21,3,0,0,31,17:2004:False:False,False,False
Texans,7,0,0,7,0,14,Browns,3,6,7,6,0,22,17:2004:False:False,False,False
Seahawks,7,7,7,7,0,28,Falcons,7,10,0,9,0,26,17:2004:False:False,False,False
Cardinals,3,3,0,6,0,12,Buccaneers,0,0,7,0,0,7,17:2004:False:False,False,False
Chargers,3,14,0,7,0,24,Chiefs,0,3,0,14,0,17,17:2004:False:False,False,False
Raiders,3,3,0,0,0,6,Jaguars,0,3,10,0,0,13,17:2004:False:False,False,False
Broncos,7,13,10,3,0,33,Colts,7,7,0,0,0,14,17:2004:False:False,False,False
Giants,0,7,0,21,0,28,Cowboys,3,6,7,8,0,24,17:2004:False:False,False,False
Seahawks,3,7,3,7,0,20,Rams,7,7,3,10,0,27,18:2004:False:True,False,True
Chargers,0,7,0,10,0,17,Jets,0,7,10,0,3,20,18:2004:False:True,False,True
Colts,14,21,0,14,0,49,Broncos,0,3,14,7,0,24,18:2004:False:True,False,True
Packers,3,7,0,7,0,17,Vikings,17,7,0,7,0,31,18:2004:False:True,False,True
Steelers,10,0,0,7,3,20,Jets,0,10,7,0,0,17,19:2004:False:True,False,True
Falcons,14,14,10,9,0,47,Rams,7,10,0,0,0,17,19:2004:False:True,False,True
Eagles,7,14,0,6,0,27,Vikings,0,7,0,7,0,14,19:2004:False:True,False,True
Patriots,0,6,7,7,0,20,Colts,0,3,0,0,0,3,19:2004:False:True,False,True
Eagles,7,7,6,7,0,27,Falcons,0,10,0,0,0,10,20:2004:False:True,False,True
Steelers,3,0,14,10,0,27,Patriots,10,14,7,10,0,41,20:2004:False:True,False,True
Eagles,0,7,7,7,0,21,Patriots,0,7,7,10,0,24,21:2004:False:True,False,True
Packers,0,7,0,3,0,10,Chargers,0,0,7,0,0,7,1:2005:True:False,True,False
Jets,0,7,0,3,0,10,Lions,0,3,0,0,0,3,1:2005:True:False,True,False
Bengals,0,6,0,7,0,13,Patriots,0,10,6,7,0,23,1:2005:True:False,True,False
Saints,3,0,7,5,0,15,Seahawks,7,17,3,7,0,34,1:2005:True:False,True,False
Rams,0,7,10,0,0,17,Bears,0,7,0,6,0,13,1:2005:True:False,True,False
Vikings,7,13,0,7,0,27,Chiefs,3,0,6,7,0,16,1:2005:True:False,True,False
Titans,0,7,7,3,0,17,Buccaneers,7,0,7,3,3,20,1:2005:True:False,True,False
Jaguars,7,7,6,7,0,27,Dolphins,0,3,0,14,0,17,1:2005:True:False,True,False
Falcons,3,0,0,13,0,16,Ravens,0,3,0,0,0,3,1:2005:True:False,True,False
Panthers,7,7,0,14,0,28,Redskins,0,3,7,0,0,10,1:2005:True:False,True,False
Texans,7,0,0,7,0,14,Broncos,0,10,0,10,0,20,1:2005:True:False,True,False
Browns,0,7,7,3,0,17,Giants,7,0,0,7,0,14,1:2005:True:False,True,False
Colts,3,0,7,0,0,10,Bills,7,10,0,0,0,17,1:2005:True:False,True,False
49ers,0,0,21,0,0,21,Raiders,3,3,0,7,0,13,1:2005:True:False,True,False
Cardinals,3,7,0,3,0,13,Cowboys,0,3,0,8,0,11,1:2005:True:False,True,False
Steelers,14,14,3,7,0,38,Eagles,0,10,14,7,0,31,1:2005:True:False,True,False
Patriots,10,14,3,0,0,27,Saints,3,13,6,15,0,37,2:2005:True:False,True,False
Falcons,14,0,7,0,0,21,Titans,3,13,0,8,0,24,2:2005:True:False,True,False
Jets,0,14,7,7,0,28,Vikings,0,7,7,7,0,21,2:2005:True:False,True,False
Redskins,7,3,0,7,0,17,Bengals,0,14,7,3,0,24,2:2005:True:False,True,False
Lions,3,7,0,3,0,13,Browns,7,0,0,14,0,21,2:2005:True:False,True,False
Bills,7,10,3,7,0,27,Packers,7,0,0,0,0,7,2:2005:True:False,True,False
Steelers,7,3,7,0,0,17,Dolphins,0,0,0,3,0,3,2:2005:True:False,True,False
Buccaneers,3,3,0,11,0,17,Jaguars,3,3,7,7,0,20,2:2005:True:False,True,False
Giants,7,10,3,7,0,27,Panthers,7,7,0,7,0,21,2:2005:True:False,True,False
Texans,7,0,3,9,0,19,Raiders,14,3,0,0,0,17,2:2005:True:False,True,False
Ravens,0,7,0,7,0,14,Eagles,7,10,0,3,0,20,2:2005:True:False,True,False
Colts,0,7,10,0,0,17,Bears,7,7,3,7,0,24,2:2005:True:False,True,False
Chiefs,10,0,0,7,0,17,Cardinals,0,0,17,7,0,24,2:2005:True:False,True,False
Broncos,10,0,7,9,0,26,49ers,0,7,7,7,0,21,2:2005:True:False,True,False
Chargers,10,17,9,0,0,36,Rams,0,14,0,7,0,21,2:2005:True:False,True,False
Seahawks,7,0,0,3,0,10,Cowboys,3,7,6,2,0,18,2:2005:True:False,True,False
Jaguars,0,7,0,0,0,7,Falcons,10,10,0,3,0,23,3:2005:True:False,True,False
Eagles,10,17,0,0,0,27,Bengals,0,3,0,14,0,17,3:2005:True:False,True,False
Vikings,3,13,3,0,0,19,Chargers,7,0,3,6,0,16,3:2005:True:False,True,False
Packers,0,3,0,0,0,3,Patriots,10,10,7,0,0,27,3:2005:True:False,True,False
Redskins,3,7,7,0,0,17,Steelers,7,3,0,0,0,10,3:2005:True:False,True,False
Saints,0,6,0,0,0,6,Ravens,7,7,0,7,0,21,3:2005:True:False,True,False
Bears,3,0,7,6,0,16,Bills,6,3,3,0,0,12,3:2005:True:False,True,False
Giants,3,6,3,3,0,15,Jets,0,7,7,0,0,14,3:2005:True:False,True,False
Browns,0,10,0,10,0,20,Panthers,6,10,0,7,0,23,3:2005:True:False,True,False
Raiders,3,10,3,0,0,16,Cardinals,0,11,0,6,0,17,3:2005:True:False,True,False
49ers,7,3,3,0,3,16,Titans,0,3,7,3,0,13,3:2005:True:False,True,False
Dolphins,7,0,0,10,0,17,Buccaneers,3,0,11,0,0,14,3:2005:True:False,True,False
Cowboys,0,7,0,14,0,21,Texans,0,0,3,6,0,9,3:2005:True:False,True,False
Broncos,10,7,10,10,0,37,Colts,0,17,0,7,0,24,3:2005:True:False,True,False
Chiefs,7,7,0,3,0,17,Seahawks,7,3,10,3,0,23,3:2005:True:False,True,False
Lions,0,6,0,7,0,13,Rams,14,7,13,3,0,37,3:2005:True:False,True,False
Buccaneers,10,14,14,0,0,38,Texans,0,0,7,7,0,14,4:2005:True:False,True,False
Eagles,0,0,7,7,0,14,Jets,10,17,7,3,0,37,4:2005:True:False,True,False
Dolphins,0,3,0,14,0,17,Falcons,3,10,0,7,0,20,4:2005:True:False,True,False
Panthers,7,3,7,0,0,17,Steelers,0,10,3,8,0,21,4:2005:True:False,True,False
Cowboys,10,3,7,7,0,27,Jaguars,7,3,7,3,0,20,4:2005:True:False,True,False
Bears,0,0,0,6,0,6,Browns,0,10,3,3,0,16,4:2005:True:False,True,False
Ravens,0,3,3,14,6,26,Redskins,0,10,7,3,0,20,4:2005:True:False,True,False
Titans,10,7,0,0,0,17,Packers,0,7,7,7,0,21,4:2005:True:False,True,False
Patriots,0,0,3,0,0,3,Giants,6,0,14,7,0,27,4:2005:True:False,True,False
Raiders,7,3,3,0,0,13,Saints,0,6,0,0,0,6,4:2005:True:False,True,False
Chargers,7,7,0,14,0,28,49ers,7,7,7,3,0,24,4:2005:True:False,True,False
Bills,0,0,7,0,0,7,Lions,7,7,7,0,0,21,4:2005:True:False,True,False
Bengals,14,14,7,3,0,38,Colts,0,0,0,0,0,0,4:2005:True:False,True,False
Rams,3,7,10,7,0,27,Chiefs,3,17,0,3,0,23,4:2005:True:False,True,False
Seahawks,7,0,7,7,0,21,Vikings,7,3,0,13,0,23,4:2005:True:False,True,False
Cardinals,7,3,3,8,0,21,Broncos,3,14,7,6,0,30,4:2005:True:False,True,False
Patriots,10,7,6,7,0,30,Raiders,7,7,0,6,0,20,1:2005:False:False,False,False
Vikings,7,0,3,3,0,13,Buccaneers,0,17,0,7,0,24,1:2005:False:False,False,False
Chiefs,14,3,3,7,0,27,Jets,0,0,0,7,0,7,1:2005:False:False,False,False
Panthers,7,0,7,6,0,20,Saints,7,7,3,6,0,23,1:2005:False:False,False,False
Bills,6,13,0,3,0,22,Texans,0,7,0,0,0,7,1:2005:False:False,False,False
Redskins,0,6,3,0,0,9,Bears,0,0,7,0,0,7,1:2005:False:False,False,False
Steelers,7,13,14,0,0,34,Titans,7,0,0,0,0,7,1:2005:False:False,False,False
Dolphins,3,3,7,21,0,34,Broncos,0,3,0,7,0,10,1:2005:False:False,False,False
Browns,3,7,0,3,0,13,Bengals,0,17,10,0,0,27,1:2005:False:False,False,False
Jaguars,6,7,7,6,0,26,Seahawks,0,14,0,0,0,14,1:2005:False:False,False,False
Chargers,7,7,10,0,0,24,Cowboys,0,14,7,7,0,28,1:2005:False:False,False,False
49ers,0,21,7,0,0,28,Rams,3,6,3,13,0,25,1:2005:False:False,False,False
Giants,7,0,21,14,0,42,Cardinals,0,13,6,0,0,19,1:2005:False:False,False,False
Lions,7,0,3,7,0,17,Packers,0,3,0,0,0,3,1:2005:False:False,False,False
Ravens,0,0,0,7,0,7,Colts,0,3,14,7,0,24,1:2005:False:False,False,False
Falcons,14,0,0,0,0,14,Eagles,0,7,0,3,0,10,1:2005:False:False,False,False
Panthers,7,10,3,7,0,27,Patriots,7,0,10,0,0,17,2:2005:False:False,False,False
Texans,0,0,7,0,0,7,Steelers,10,10,7,0,0,27,2:2005:False:False,False,False
Eagles,14,14,7,7,0,42,49ers,0,0,3,0,0,3,2:2005:False:False,False,False
Bears,10,21,0,7,0,38,Lions,6,0,0,0,0,6,2:2005:False:False,False,False
Colts,0,0,0,10,0,10,Jaguars,0,0,3,0,0,3,2:2005:False:False,False,False
Bengals,14,13,7,3,0,37,Vikings,0,0,0,8,0,8,2:2005:False:False,False,False
Buccaneers,0,9,7,3,0,19,Bills,0,3,0,0,0,3,2:2005:False:False,False,False
Titans,7,6,3,9,0,25,Ravens,0,0,3,7,0,10,2:2005:False:False,False,False
Cardinals,3,3,3,3,0,12,Rams,7,3,7,0,0,17,2:2005:False:False,False,False
Seahawks,0,21,0,0,0,21,Falcons,0,0,10,8,0,18,2:2005:False:False,False,False
Broncos,3,0,7,10,0,20,Chargers,0,14,0,3,0,17,2:2005:False:False,False,False
Jets,7,3,0,7,0,17,Dolphins,0,0,0,7,0,7,2:2005:False:False,False,False
Packers,7,0,0,17,0,24,Browns,7,6,6,7,0,26,2:2005:False:False,False,False
Raiders,0,10,7,0,0,17,Chiefs,7,10,3,3,0,23,2:2005:False:False,False,False
Saints,0,10,0,0,0,10,Giants,14,7,3,3,0,27,2:2005:False:False,False,False
Cowboys,0,3,7,3,0,13,Redskins,0,0,0,14,0,14,2:2005:False:False,False,False
Dolphins,14,7,0,6,0,27,Panthers,3,14,0,7,0,24,3:2005:False:False,False,False
Bears,0,0,0,7,0,7,Bengals,10,0,7,7,0,24,3:2005:False:False,False,False
Colts,7,3,3,0,0,13,Browns,0,3,0,3,0,6,3:2005:False:False,False,False
Jets,0,7,7,6,0,20,Jaguars,3,7,3,7,6,26,3:2005:False:False,False,False
Vikings,17,7,0,9,0,33,Saints,0,6,3,7,0,16,3:2005:False:False,False,False
Packers,6,7,0,3,0,16,Buccaneers,7,10,0,0,0,17,3:2005:False:False,False,False
Rams,0,17,7,7,0,31,Titans,10,0,14,3,0,27,3:2005:False:False,False,False
Bills,3,10,3,0,0,16,Falcons,7,10,0,7,0,24,3:2005:False:False,False,False
Eagles,0,6,14,3,0,23,Raiders,7,3,0,10,0,20,3:2005:False:False,False,False
49ers,7,17,7,0,0,31,Cowboys,0,12,7,15,0,34,3:2005:False:False,False,False
Seahawks,7,3,14,13,0,37,Cardinals,3,6,3,0,0,12,3:2005:False:False,False,False
Steelers,10,0,3,7,0,20,Patriots,7,0,3,13,0,23,3:2005:False:False,False,False
Chargers,7,14,14,10,0,45,Giants,3,17,0,3,0,23,3:2005:False:False,False,False
Broncos,17,3,7,3,0,30,Chiefs,0,3,0,7,0,10,3:2005:False:False,False,False
Jaguars,0,0,7,0,0,7,Broncos,0,14,0,6,0,20,4:2005:False:False,False,False
Buccaneers,3,7,7,0,0,17,Lions,0,10,0,3,0,13,4:2005:False:False,False,False
Bengals,3,7,0,6,0,16,Texans,0,3,7,0,0,10,4:2005:False:False,False,False
Titans,3,0,0,7,0,10,Colts,7,10,7,7,0,31,4:2005:False:False,False,False
Saints,0,13,0,6,0,19,Bills,7,0,0,0,0,7,4:2005:False:False,False,False
Patriots,7,10,0,0,0,17,Chargers,3,14,14,10,0,41,4:2005:False:False,False,False
Giants,17,10,7,10,0,44,Rams,7,10,0,7,0,24,4:2005:False:False,False,False
Redskins,0,7,10,0,3,20,Seahawks,3,0,7,7,0,17,4:2005:False:False,False,False
Ravens,3,3,7,0,0,13,Jets,0,0,3,0,0,3,4:2005:False:False,False,False
Raiders,10,0,3,6,0,19,Cowboys,0,3,3,7,0,13,4:2005:False:False,False,False
Falcons,7,17,3,3,0,30,Vikings,0,0,0,10,0,10,4:2005:False:False,False,False
Chiefs,10,14,0,7,0,31,Eagles,0,13,11,13,0,37,4:2005:False:False,False,False
Cardinals,0,12,6,13,0,31,49ers,14,0,0,0,0,14,4:2005:False:False,False,False
Panthers,7,16,3,6,0,32,Packers,7,0,6,16,0,29,4:2005:False:False,False,False
Browns,3,3,0,14,0,20,Bears,0,3,7,0,0,10,5:2005:False:False,False,False
Bills,10,7,0,3,0,20,Dolphins,0,0,7,7,0,14,5:2005:False:False,False,False
Falcons,0,13,0,15,0,28,Patriots,14,0,14,3,0,31,5:2005:False:False,False,False
Packers,14,21,10,7,0,52,Saints,3,0,0,0,0,3,5:2005:False:False,False,False
Rams,7,14,7,3,0,31,Seahawks,14,10,10,3,0,37,5:2005:False:False,False,False
Texans,0,6,3,11,0,20,Titans,7,3,14,10,0,34,5:2005:False:False,False,False
Lions,14,0,7,14,0,35,Ravens,0,10,0,7,0,17,5:2005:False:False,False,False
Jets,0,7,7,0,0,14,Buccaneers,3,6,0,3,0,12,5:2005:False:False,False,False
49ers,0,0,3,0,0,3,Colts,7,7,0,14,0,28,5:2005:False:False,False,False
Cardinals,0,17,3,0,0,20,Panthers,3,7,0,14,0,24,5:2005:False:False,False,False
Cowboys,17,10,3,3,0,33,Eagles,0,3,7,0,0,10,5:2005:False:False,False,False
Broncos,7,7,7,0,0,21,Redskins,7,3,0,9,0,19,5:2005:False:False,False,False
Jaguars,10,3,7,3,0,23,Bengals,0,7,6,7,0,20,5:2005:False:False,False,False
Chargers,0,7,6,9,0,22,Steelers,0,14,0,10,0,24,5:2005:False:False,False,False
Lions,0,14,3,3,0,20,Panthers,7,7,0,7,0,21,6:2005:False:False,False,False
Titans,0,10,7,6,0,23,Bengals,0,7,10,14,0,31,6:2005:False:False,False,False
Ravens,10,6,0,0,0,16,Browns,0,0,3,0,0,3,6:2005:False:False,False,False
Steelers,0,14,0,3,0,17,Jaguars,7,3,7,0,6,23,6:2005:False:False,False,False
Buccaneers,10,0,17,0,0,27,Dolphins,3,0,3,7,0,13,6:2005:False:False,False,False
Cowboys,0,7,0,6,3,16,Giants,3,3,0,7,0,13,6:2005:False:False,False,False
Chiefs,3,3,15,7,0,28,Redskins,0,7,14,0,0,21,6:2005:False:False,False,False
Saints,7,3,7,14,0,31,Falcons,3,14,0,17,0,34,6:2005:False:False,False,False
Bears,0,7,7,14,0,28,Vikings,0,3,0,0,0,3,6:2005:False:False,False,False
Bills,7,10,7,3,0,27,Jets,0,10,7,0,0,17,6:2005:False:False,False,False
Raiders,7,0,7,0,0,14,Chargers,14,10,3,0,0,27,6:2005:False:False,False,False
Broncos,0,21,7,0,0,28,Patriots,3,0,3,14,0,20,6:2005:False:False,False,False
Seahawks,14,7,7,14,0,42,Texans,0,3,7,0,0,10,6:2005:False:False,False,False
Colts,0,14,10,21,0,45,Rams,17,3,0,8,0,28,6:2005:False:False,False,False
Dolphins,0,6,7,7,0,20,Chiefs,7,7,10,6,0,30,7:2005:False:False,False,False
Vikings,0,0,10,13,0,23,Packers,0,17,0,3,0,20,7:2005:False:False,False,False
Texans,0,14,0,6,0,20,Colts,7,7,10,14,0,38,7:2005:False:False,False,False
Rams,0,7,0,21,0,28,Saints,14,0,0,3,0,17,7:2005:False:False,False,False
Bengals,3,3,0,7,0,13,Steelers,0,7,17,3,0,27,7:2005:False:False,False,False
Browns,3,7,0,0,0,10,Lions,0,7,3,3,0,13,7:2005:False:False,False,False
Eagles,0,7,3,10,0,20,Chargers,0,0,7,10,0,17,7:2005:False:False,False,False
Redskins,14,21,10,7,0,52,49ers,7,0,0,10,0,17,7:2005:False:False,False,False
Seahawks,0,3,0,10,0,13,Cowboys,7,0,0,3,0,10,7:2005:False:False,False,False
Bears,7,0,3,0,0,10,Ravens,0,6,0,0,0,6,7:2005:False:False,False,False
Raiders,0,17,7,14,0,38,Bills,7,3,0,7,0,17,7:2005:False:False,False,False
Giants,7,3,0,14,0,24,Broncos,6,7,7,3,0,23,7:2005:False:False,False,False
Cardinals,0,10,3,7,0,20,Titans,10,0,0,0,0,10,7:2005:False:False,False,False
Falcons,10,10,7,0,0,27,Jets,0,7,0,7,0,14,7:2005:False:False,False,False
Lions,3,0,7,3,0,13,Bears,0,13,0,0,6,19,8:2005:False:False,False,False
Texans,7,3,3,6,0,19,Browns,10,3,0,3,0,16,8:2005:False:False,False,False
Bengals,7,7,0,7,0,21,Packers,0,7,0,7,0,14,8:2005:False:False,False,False
Rams,14,3,0,7,0,24,Jaguars,7,7,7,0,0,21,8:2005:False:False,False,False
Cowboys,10,14,3,7,0,34,Cardinals,3,7,3,0,0,13,8:2005:False:False,False,False
Panthers,7,17,7,7,0,38,Vikings,0,0,7,6,0,13,8:2005:False:False,False,False
Giants,6,13,17,0,0,36,Redskins,0,0,0,0,0,0,8:2005:False:False,False,False
Titans,0,22,0,3,0,25,Raiders,17,7,3,7,0,34,8:2005:False:False,False,False
Chargers,7,14,0,7,0,28,Chiefs,0,3,7,10,0,20,8:2005:False:False,False,False
Saints,3,0,3,0,0,6,Dolphins,3,6,2,10,0,21,8:2005:False:False,False,False
Broncos,14,14,0,21,0,49,Eagles,0,7,14,0,0,21,8:2005:False:False,False,False
49ers,0,6,6,3,0,15,Buccaneers,0,3,0,7,0,10,8:2005:False:False,False,False
Patriots,0,0,7,14,0,21,Bills,0,3,7,6,0,16,8:2005:False:False,False,False
Steelers,7,3,7,3,0,20,Ravens,7,3,0,9,0,19,8:2005:False:False,False,False
Buccaneers,0,7,0,7,0,14,Panthers,10,7,10,7,0,34,9:2005:False:False,False,False
Ravens,3,3,0,3,0,9,Bengals,0,14,0,7,0,21,9:2005:False:False,False,False
Vikings,3,21,0,3,0,27,Lions,0,7,0,7,0,14,9:2005:False:False,False,False
Jaguars,0,0,7,14,0,21,Texans,0,7,7,0,0,14,9:2005:False:False,False,False
Dolphins,0,10,0,0,0,10,Falcons,7,7,3,0,0,17,9:2005:False:False,False,False
Chiefs,0,6,7,14,0,27,Raiders,3,6,0,14,0,23,9:2005:False:False,False,False
Browns,7,0,10,3,0,20,Titans,0,7,0,7,0,14,9:2005:False:False,False,False
Jets,0,10,3,13,0,26,Chargers,14,7,7,3,0,31,9:2005:False:False,False,False
49ers,0,0,6,0,0,6,Giants,3,7,0,14,0,24,9:2005:False:False,False,False
Cardinals,3,3,10,3,0,19,Seahawks,3,14,10,6,0,33,9:2005:False:False,False,False
Saints,3,7,0,7,0,17,Bears,7,3,7,3,0,20,9:2005:False:False,False,False
Packers,3,0,7,0,0,10,Steelers,6,7,0,7,0,20,9:2005:False:False,False,False
Redskins,0,10,7,0,0,17,Eagles,7,0,3,0,0,10,9:2005:False:False,False,False
Patriots,7,0,7,7,0,21,Colts,7,14,10,9,0,40,9:2005:False:False,False,False
Colts,7,14,7,3,0,31,Texans,0,7,10,0,0,17,10:2005:False:False,False,False
Bills,0,7,7,0,0,14,Chiefs,3,0,0,0,0,3,10:2005:False:False,False,False
Giants,0,6,7,8,0,21,Vikings,0,7,14,3,0,24,10:2005:False:False,False,False
Dolphins,0,7,0,9,0,16,Patriots,0,3,9,11,0,23,10:2005:False:False,False,False
Jaguars,0,10,7,13,0,30,Ravens,3,0,0,0,0,3,10:2005:False:False,False,False
Bears,0,7,0,10,0,17,49ers,0,3,3,3,0,9,10:2005:False:False,False,False
Lions,9,10,7,3,0,29,Cardinals,0,3,8,10,0,21,10:2005:False:False,False,False
Raiders,0,0,0,17,0,17,Broncos,0,13,10,8,0,31,10:2005:False:False,False,False
Panthers,7,3,0,20,0,30,Jets,0,3,0,0,0,3,10:2005:False:False,False,False
Seahawks,0,10,14,7,0,31,Rams,3,0,6,7,0,16,10:2005:False:False,False,False
Falcons,0,14,0,11,0,25,Packers,14,3,6,10,0,33,10:2005:False:False,False,False
Buccaneers,7,14,7,8,0,36,Redskins,3,10,15,7,0,35,10:2005:False:False,False,False
Steelers,0,17,7,10,0,34,Browns,7,0,0,14,0,21,10:2005:False:False,False,False
Eagles,7,7,3,3,0,20,Cowboys,7,0,0,14,0,21,10:2005:False:False,False,False
Ravens,0,13,0,0,3,16,Steelers,0,6,0,7,0,13,11:2005:False:False,False,False
Cowboys,7,6,7,0,0,20,Lions,0,7,0,0,0,7,11:2005:False:False,False,False
Titans,0,14,7,7,0,28,Jaguars,0,7,14,10,0,31,11:2005:False:False,False,False
Browns,9,3,10,0,0,22,Dolphins,0,0,0,0,0,0,11:2005:False:False,False,False
Patriots,7,7,7,3,0,24,Saints,0,7,0,10,0,17,11:2005:False:False,False,False
Redskins,7,6,0,0,0,13,Raiders,3,0,7,6,0,16,11:2005:False:False,False,False
Giants,0,10,3,14,0,27,Eagles,0,0,10,7,0,17,11:2005:False:False,False,False
Falcons,0,10,7,10,0,27,Buccaneers,10,3,7,10,0,30,11:2005:False:False,False,False
Rams,3,7,7,11,0,28,Cardinals,3,10,3,22,0,38,11:2005:False:False,False,False
Bears,10,3,0,0,0,13,Panthers,0,0,0,3,0,3,11:2005:False:False,False,False
49ers,3,6,3,13,0,25,Seahawks,3,14,10,0,0,27,11:2005:False:False,False,False
Bengals,10,17,7,3,0,37,Colts,14,21,7,3,0,45,11:2005:False:False,False,False
Chargers,14,21,3,10,0,48,Bills,3,7,0,0,0,10,11:2005:False:False,False,False
Broncos,7,10,0,10,0,27,Jets,0,0,0,0,0,0,11:2005:False:False,False,False
Texans,7,0,10,0,0,17,Chiefs,10,21,0,14,0,45,11:2005:False:False,False,False
Packers,7,7,0,3,0,17,Vikings,0,7,7,6,0,20,11:2005:False:False,False,False
Lions,0,0,0,7,0,7,Falcons,10,7,10,0,0,27,12:2005:False:False,False,False
Cowboys,7,7,0,7,0,21,Broncos,7,7,7,0,3,24,12:2005:False:False,False,False
Vikings,3,7,7,7,0,24,Browns,0,3,3,6,0,12,12:2005:False:False,False,False
Chiefs,7,12,7,0,0,26,Patriots,0,3,7,6,0,16,12:2005:False:False,False,False
Redskins,3,7,7,0,0,17,Chargers,0,7,0,10,6,23,12:2005:False:False,False,False
Texans,7,17,0,3,0,27,Rams,0,3,7,17,6,33,12:2005:False:False,False,False
Buccaneers,3,0,0,7,0,10,Bears,7,3,3,0,0,13,12:2005:False:False,False,False
Bengals,3,14,17,8,0,42,Ravens,0,0,14,15,0,29,12:2005:False:False,False,False
Bills,0,6,0,3,0,9,Panthers,0,3,3,7,0,13,12:2005:False:False,False,False
Titans,3,6,21,3,0,33,49ers,0,14,0,8,0,22,12:2005:False:False,False,False
Cardinals,0,0,3,14,0,17,Jaguars,7,3,7,7,0,24,12:2005:False:False,False,False
Raiders,0,7,7,7,0,21,Dolphins,7,7,9,10,0,33,12:2005:False:False,False,False
Eagles,10,0,3,6,0,19,Packers,7,7,0,0,0,14,12:2005:False:False,False,False
Seahawks,7,0,7,7,3,24,Giants,0,10,3,8,0,21,12:2005:False:False,False,False
Jets,3,6,7,3,0,19,Saints,0,14,0,7,0,21,12:2005:False:False,False,False
Colts,10,6,7,3,0,26,Steelers,7,0,0,0,0,7,12:2005:False:False,False,False
Bears,0,9,0,10,0,19,Packers,0,7,0,0,0,7,13:2005:False:False,False,False
Ravens,0,7,0,9,0,16,Texans,3,3,0,9,0,15,13:2005:False:False,False,False
Browns,0,14,0,0,0,14,Jaguars,3,0,17,0,0,20,13:2005:False:False,False,False
Lions,3,3,3,7,0,16,Vikings,7,7,7,0,0,21,13:2005:False:False,False,False
Saints,0,3,0,0,0,3,Buccaneers,0,7,0,3,0,10,13:2005:False:False,False,False
Colts,7,7,14,7,0,35,Titans,0,3,0,0,0,3,13:2005:False:False,False,False
Panthers,7,7,0,10,0,24,Falcons,3,3,0,0,0,6,13:2005:False:False,False,False
Dolphins,0,3,0,21,0,24,Bills,21,0,2,0,0,23,13:2005:False:False,False,False
Giants,0,10,7,0,0,17,Cowboys,0,0,10,0,0,10,13:2005:False:False,False,False
Steelers,14,3,7,7,0,31,Bengals,7,14,10,7,0,38,13:2005:False:False,False,False
49ers,0,7,3,0,0,10,Cardinals,3,0,6,8,0,17,13:2005:False:False,False,False
Rams,0,7,0,2,0,9,Redskins,7,3,0,14,0,24,13:2005:False:False,False,False
Patriots,0,6,7,3,0,16,Jets,0,3,0,0,0,3,13:2005:False:False,False,False
Chiefs,7,14,3,7,0,31,Broncos,7,14,3,3,0,27,13:2005:False:False,False,False
Chargers,3,14,7,10,0,34,Raiders,3,7,0,0,0,10,13:2005:False:False,False,False
Eagles,0,0,0,0,0,0,Seahawks,14,21,7,0,0,42,13:2005:False:False,False,False
Jaguars,0,3,0,15,0,18,Colts,7,10,6,3,0,26,14:2005:False:False,False,False
Vikings,7,6,14,0,0,27,Rams,0,6,7,0,0,13,14:2005:False:False,False,False
Panthers,0,0,3,7,0,10,Buccaneers,7,3,3,7,0,20,14:2005:False:False,False,False
Bills,0,0,0,7,0,7,Patriots,7,7,7,14,0,35,14:2005:False:False,False,False
Jets,3,3,6,14,0,26,Raiders,0,3,0,7,0,10,14:2005:False:False,False,False
Titans,0,3,7,3,0,13,Texans,3,7,0,0,0,10,14:2005:False:False,False,False
Bengals,7,6,7,3,0,23,Browns,7,7,3,3,0,20,14:2005:False:False,False,False
Steelers,7,7,7,0,0,21,Bears,3,0,0,6,0,9,14:2005:False:False,False,False
Eagles,7,10,0,6,0,23,Giants,7,10,3,3,3,26,14:2005:False:False,False,False
Cardinals,0,10,3,0,0,13,Redskins,0,3,14,0,0,17,14:2005:False:False,False,False
Seahawks,7,17,14,3,0,41,49ers,3,0,0,0,0,3,14:2005:False:False,False,False
Chargers,7,0,0,14,0,21,Dolphins,0,3,17,3,0,23,14:2005:False:False,False,False
Cowboys,0,17,0,14,0,31,Chiefs,7,7,7,7,0,28,14:2005:False:False,False,False
Broncos,3,3,6,0,0,12,Ravens,3,0,0,7,0,10,14:2005:False:False,False,False
Packers,3,7,0,3,3,16,Lions,13,0,0,0,0,13,14:2005:False:False,False,False
Falcons,7,14,9,6,0,36,Saints,3,14,0,0,0,17,14:2005:False:False,False,False
Patriots,7,14,0,7,0,28,Buccaneers,0,0,0,0,0,0,15:2005:False:False,False,False
Giants,0,10,3,14,0,27,Chiefs,0,3,7,7,0,17,15:2005:False:False,False,False
Bills,7,0,3,7,0,17,Broncos,0,7,14,7,0,28,15:2005:False:False,False,False
Colts,0,0,17,0,0,17,Chargers,10,3,3,10,0,26,15:2005:False:False,False,False
Rams,3,10,3,0,0,16,Eagles,7,0,3,7,0,17,15:2005:False:False,False,False
Jaguars,0,7,0,3,0,10,49ers,3,3,0,3,0,9,15:2005:False:False,False,False
Titans,0,14,10,0,0,24,Seahawks,14,0,7,7,0,28,15:2005:False:False,False,False
Vikings,3,0,0,0,0,3,Steelers,3,7,6,2,0,18,15:2005:False:False,False,False
Dolphins,7,3,0,14,0,24,Jets,0,10,7,3,0,20,15:2005:False:False,False,False
Saints,7,0,0,3,0,10,Panthers,7,10,7,3,0,27,15:2005:False:False,False,False
Texans,0,24,3,3,0,30,Cardinals,3,7,0,9,0,19,15:2005:False:False,False,False
Raiders,0,7,0,0,0,7,Browns,0,3,3,3,0,9,15:2005:False:False,False,False
Lions,0,7,3,7,0,17,Bengals,17,7,7,10,0,41,15:2005:False:False,False,False
Redskins,7,21,7,0,0,35,Cowboys,0,0,0,7,0,7,15:2005:False:False,False,False
Bears,0,6,10,0,0,16,Falcons,0,3,0,0,0,3,15:2005:False:False,False,False
Ravens,14,10,10,14,0,48,Packers,3,0,0,0,0,3,15:2005:False:False,False,False
Texans,3,10,0,7,0,20,Jaguars,7,3,7,21,0,38,16:2005:False:False,False,False
Redskins,14,7,7,7,0,35,Giants,10,7,3,0,0,20,16:2005:False:False,False,False
Browns,0,0,0,0,0,0,Steelers,14,6,14,7,0,41,16:2005:False:False,False,False
Chiefs,7,13,0,0,0,20,Chargers,7,0,0,0,0,7,16:2005:False:False,False,False
Rams,3,17,0,0,0,20,49ers,7,10,0,7,0,24,16:2005:False:False,False,False
Dolphins,0,17,0,7,0,24,Titans,3,0,0,7,0,10,16:2005:False:False,False,False
Saints,0,3,6,3,0,12,Lions,0,7,0,6,0,13,16:2005:False:False,False,False
Panthers,10,3,0,7,0,20,Cowboys,7,3,7,7,0,24,16:2005:False:False,False,False
Buccaneers,7,7,0,10,3,27,Falcons,7,10,0,7,0,24,16:2005:False:False,False,False
Bengals,0,14,10,3,0,27,Bills,6,7,7,17,0,37,16:2005:False:False,False,False
Cardinals,6,7,7,7,0,27,Eagles,0,7,0,14,0,21,16:2005:False:False,False,False
Seahawks,7,7,7,7,0,28,Colts,3,3,0,7,0,13,16:2005:False:False,False,False
Broncos,10,6,6,0,0,22,Raiders,0,0,0,3,0,3,16:2005:False:False,False,False
Packers,0,7,0,10,0,17,Bears,7,7,10,0,0,24,16:2005:False:False,False,False
Ravens,7,3,7,13,0,30,Vikings,7,7,6,3,0,23,16:2005:False:False,False,False
Jets,7,0,0,14,0,21,Patriots,7,14,7,3,0,31,16:2005:False:False,False,False
Chargers,0,7,0,0,0,7,Broncos,0,14,2,7,0,23,17:2005:False:False,False,False
Raiders,7,7,7,0,0,21,Giants,7,13,7,3,0,30,17:2005:False:False,False,False
Falcons,3,0,0,8,0,11,Panthers,14,13,10,7,0,44,17:2005:False:False,False,False
Patriots,7,3,3,13,0,26,Dolphins,7,6,5,10,0,28,17:2005:False:False,False,False
Colts,7,3,7,0,0,17,Cardinals,0,3,7,3,0,13,17:2005:False:False,False,False
Browns,0,6,14,0,0,20,Ravens,0,13,3,0,0,16,17:2005:False:False,False,False
Jets,3,14,3,10,0,30,Bills,3,10,10,3,0,26,17:2005:False:False,False,False
Buccaneers,7,10,0,10,0,27,Saints,0,10,0,3,0,13,17:2005:False:False,False,False
Packers,6,7,7,3,0,23,Seahawks,0,7,7,3,0,17,17:2005:False:False,False,False
Chiefs,3,17,10,7,0,37,Bengals,3,0,0,0,0,3,17:2005:False:False,False,False
Steelers,14,7,14,0,0,35,Lions,14,0,7,0,0,21,17:2005:False:False,False,False
Jaguars,17,10,13,0,0,40,Titans,0,0,0,13,0,13,17:2005:False:False,False,False
49ers,0,7,10,0,3,20,Texans,10,0,7,0,0,17,17:2005:False:False,False,False
Vikings,0,17,7,10,0,34,Bears,3,0,0,7,0,10,17:2005:False:False,False,False
Eagles,10,7,3,0,0,20,Redskins,7,3,7,14,0,31,17:2005:False:False,False,False
Cowboys,7,3,0,0,0,10,Rams,0,10,0,10,0,20,17:2005:False:False,False,False
Buccaneers,0,3,7,0,0,10,Redskins,14,3,0,0,0,17,18:2005:False:True,False,True
Patriots,0,7,14,7,0,28,Jaguars,0,3,0,0,0,3,18:2005:False:True,False,True
Giants,0,0,0,0,0,0,Panthers,0,10,7,6,0,23,18:2005:False:True,False,True
Bengals,10,7,0,0,0,17,Steelers,0,14,14,3,0,31,18:2005:False:True,False,True
Seahawks,0,7,7,6,0,20,Redskins,0,3,0,7,0,10,19:2005:False:True,False,True
Broncos,0,10,7,10,0,27,Patriots,0,3,3,7,0,13,19:2005:False:True,False,True
Colts,0,3,0,15,0,18,Steelers,14,0,7,0,0,21,19:2005:False:True,False,True
Bears,0,7,7,7,0,21,Panthers,7,9,7,6,0,29,19:2005:False:True,False,True
Broncos,0,3,7,7,0,17,Steelers,3,21,0,10,0,34,20:2005:False:True,False,True
Seahawks,10,10,7,7,0,34,Panthers,0,7,0,7,0,14,20:2005:False:True,False,True
Steelers,0,7,7,7,0,21,Seahawks,3,0,7,0,0,10,21:2005:False:True,False,True
Eagles,3,0,14,3,0,20,Browns,0,0,0,7,0,7,1:2006:True:False,True,False
Rams,12,7,0,0,0,19,Colts,10,0,0,7,0,17,1:2006:True:False,True,False
Lions,3,7,7,3,0,20,Broncos,0,6,7,0,0,13,1:2006:True:False,True,False
Buccaneers,0,3,7,6,0,16,Jets,0,3,0,0,0,3,1:2006:True:False,True,False
Falcons,10,3,10,3,0,26,Patriots,3,3,7,10,0,23,1:2006:True:False,True,False
Ravens,7,6,3,0,0,16,Giants,0,7,0,10,0,17,1:2006:True:False,True,False
49ers,10,7,3,8,0,28,Bears,0,7,7,0,0,14,1:2006:True:False,True,False
Cardinals,7,7,0,7,0,21,Steelers,0,6,0,7,0,13,1:2006:True:False,True,False
Panthers,14,0,0,0,0,14,Bills,0,3,10,0,0,13,1:2006:True:False,True,False
Dolphins,10,0,3,13,0,26,Jaguars,0,10,7,14,0,31,1:2006:True:False,True,False
Texans,7,7,3,7,0,24,Chiefs,0,7,0,7,0,14,1:2006:True:False,True,False
Titans,3,7,3,3,0,16,Saints,3,3,6,7,0,19,1:2006:True:False,True,False
Seahawks,0,3,0,0,0,3,Cowboys,7,3,3,0,0,13,1:2006:True:False,True,False
Chargers,7,7,3,0,0,17,Packers,0,0,0,3,0,3,1:2006:True:False,True,False
Bengals,9,3,7,0,0,19,Redskins,0,3,0,0,0,3,1:2006:True:False,True,False
Vikings,7,3,3,0,0,13,Raiders,6,7,0,3,0,16,1:2006:True:False,True,False
Giants,7,7,3,0,0,17,Chiefs,0,0,0,0,0,0,2:2006:True:False,True,False
Ravens,0,3,10,7,0,20,Eagles,10,0,0,0,0,10,2:2006:True:False,True,False
Bills,7,10,0,14,0,31,Bengals,7,20,10,7,0,44,2:2006:True:False,True,False
Browns,7,3,0,10,0,20,Lions,0,10,6,0,0,16,2:2006:True:False,True,False
Bears,14,0,7,3,0,24,Chargers,3,0,0,0,0,3,2:2006:True:False,True,False
Buccaneers,3,0,0,7,0,10,Dolphins,0,10,3,0,0,13,2:2006:True:False,True,False
Jaguars,0,3,0,7,0,10,Panthers,3,14,0,0,0,17,2:2006:True:False,True,False
Redskins,0,7,0,7,0,14,Jets,0,17,3,7,0,27,2:2006:True:False,True,False
Steelers,7,0,3,0,0,10,Vikings,7,3,7,0,0,17,2:2006:True:False,True,False
Rams,3,0,14,3,0,20,Texans,0,10,10,7,0,27,2:2006:True:False,True,False
Packers,7,17,0,14,0,38,Falcons,7,3,0,0,0,10,2:2006:True:False,True,False
Patriots,6,7,10,7,0,30,Cardinals,0,3,0,0,0,3,2:2006:True:False,True,False
Broncos,14,14,7,0,0,35,Titans,0,3,0,7,0,10,2:2006:True:False,True,False
Colts,7,0,3,7,0,17,Seahawks,3,17,3,7,0,30,2:2006:True:False,True,False
Raiders,7,3,7,6,0,23,49ers,0,0,0,7,0,7,2:2006:True:False,True,False
Saints,0,0,0,7,0,7,Cowboys,10,7,3,10,0,30,2:2006:True:False,True,False
Panthers,3,10,3,3,0,19,Dolphins,0,3,7,0,0,10,3:2006:True:False,True,False
Vikings,3,7,3,17,0,30,Ravens,0,0,7,0,0,7,3:2006:True:False,True,False
Bears,3,3,0,10,0,16,Cardinals,0,10,10,3,0,23,3:2006:True:False,True,False
Eagles,3,6,7,0,0,16,Steelers,0,7,0,0,0,7,3:2006:True:False,True,False
Jets,0,0,0,7,0,7,Giants,0,7,3,3,0,13,3:2006:True:False,True,False
Raiders,7,14,0,0,0,21,Lions,0,0,3,0,0,3,3:2006:True:False,True,False
Bills,7,3,0,7,0,17,Browns,7,0,3,10,0,20,3:2006:True:False,True,False
Saints,0,0,7,7,0,14,Colts,10,7,7,3,0,27,3:2006:True:False,True,False
Titans,3,3,0,0,0,6,Falcons,10,7,0,3,0,20,3:2006:True:False,True,False
Patriots,10,10,7,14,0,41,Redskins,0,0,0,0,0,0,3:2006:True:False,True,False
Cowboys,10,7,0,0,0,17,49ers,0,0,7,0,0,7,3:2006:True:False,True,False
Jaguars,0,0,15,14,0,29,Buccaneers,8,3,0,7,0,18,3:2006:True:False,True,False
Chiefs,7,9,0,0,0,16,Rams,3,0,6,3,0,12,3:2006:True:False,True,False
Chargers,14,3,0,14,0,31,Seahawks,14,0,6,0,0,20,3:2006:True:False,True,False
Broncos,0,10,0,7,0,17,Texans,0,3,3,8,0,14,3:2006:True:False,True,False
Bengals,17,17,7,7,0,48,Packers,0,7,3,7,0,17,3:2006:True:False,True,False
Dolphins,0,9,7,13,0,29,Rams,6,0,3,0,0,9,4:2006:True:False,True,False
Giants,0,10,7,14,0,31,Patriots,7,3,3,10,0,23,4:2006:True:False,True,False
Falcons,7,0,0,10,0,17,Jaguars,0,10,3,7,0,20,4:2006:True:False,True,False
Lions,0,7,0,6,0,13,Bills,7,3,0,10,0,20,4:2006:True:False,True,False
Steelers,3,3,0,7,0,13,Panthers,0,3,6,6,0,15,4:2006:True:False,True,False
Cowboys,0,3,0,7,0,10,Vikings,0,7,0,3,0,10,4:2006:True:False,True,False
Browns,0,7,0,0,0,7,Bears,10,0,3,7,0,20,4:2006:True:False,True,False
Redskins,0,0,3,7,0,10,Ravens,7,7,0,3,0,17,4:2006:True:False,True,False
Texans,7,6,0,3,0,16,Buccaneers,0,3,7,3,0,13,4:2006:True:False,True,False
Chiefs,0,3,0,7,0,10,Saints,0,0,3,6,0,9,4:2006:True:False,True,False
Cardinals,3,17,3,0,0,23,Broncos,9,6,0,14,0,29,4:2006:True:False,True,False
Seahawks,7,13,7,3,0,30,Raiders,7,0,0,0,0,7,4:2006:True:False,True,False
Packers,7,0,0,14,0,21,Titans,7,7,14,7,0,35,4:2006:True:False,True,False
Jets,0,0,10,10,0,20,Eagles,0,17,0,0,0,17,4:2006:True:False,True,False
Colts,0,0,3,0,0,3,Bengals,7,7,3,3,0,20,4:2006:True:False,True,False
49ers,0,17,6,0,0,23,Chargers,7,0,7,0,0,14,4:2006:True:False,True,False
Steelers,0,14,0,14,0,28,Dolphins,0,10,7,0,0,17,1:2006:False:False,False,False
Texans,7,3,0,0,0,10,Eagles,0,14,7,3,0,24,1:2006:False:False,False,False
Chiefs,3,0,0,7,0,10,Bengals,0,17,0,6,0,23,1:2006:False:False,False,False
Patriots,7,0,7,5,0,19,Bills,10,7,0,0,0,17,1:2006:False:False,False,False
Rams,3,9,3,3,0,18,Broncos,0,7,0,3,0,10,1:2006:False:False,False,False
Buccaneers,0,0,0,0,0,0,Ravens,7,10,3,7,0,27,1:2006:False:False,False,False
Titans,0,0,0,16,0,16,Jets,0,13,3,7,0,23,1:2006:False:False,False,False
Lions,3,0,0,3,0,6,Seahawks,0,6,0,3,0,9,1:2006:False:False,False,False
Browns,0,0,7,7,0,14,Saints,3,6,7,3,0,19,1:2006:False:False,False,False
Panthers,3,0,3,0,0,6,Falcons,3,10,7,0,0,20,1:2006:False:False,False,False
Packers,0,0,0,0,0,0,Bears,7,9,3,7,0,26,1:2006:False:False,False,False
Jaguars,0,10,0,14,0,24,Cowboys,10,0,0,7,0,17,1:2006:False:False,False,False
Cardinals,21,3,7,3,0,34,49ers,7,7,7,6,0,27,1:2006:False:False,False,False
Giants,0,7,7,7,0,21,Colts,3,13,0,10,0,26,1:2006:False:False,False,False
Redskins,3,10,3,0,0,16,Vikings,6,3,7,3,0,19,1:2006:False:False,False,False
Raiders,0,0,0,0,0,0,Chargers,3,10,0,14,0,27,1:2006:False:False,False,False
Eagles,7,10,7,0,0,24,Giants,7,0,0,17,6,30,2:2006:False:False,False,False
Dolphins,0,0,0,6,0,6,Bills,3,0,13,0,0,16,2:2006:False:False,False,False
Vikings,3,3,0,7,3,16,Panthers,0,10,3,0,0,13,2:2006:False:False,False,False
Colts,14,6,10,13,0,43,Texans,0,3,0,21,0,24,2:2006:False:False,False,False
Packers,13,0,0,14,0,27,Saints,0,14,6,14,0,34,2:2006:False:False,False,False
Bengals,14,3,0,17,0,34,Browns,3,0,0,14,0,17,2:2006:False:False,False,False
Bears,10,14,7,3,0,34,Lions,0,0,7,0,0,7,2:2006:False:False,False,False
Falcons,7,7,0,0,0,14,Buccaneers,0,3,0,0,0,3,2:2006:False:False,False,False
Ravens,9,7,2,10,0,28,Raiders,0,3,0,3,0,6,2:2006:False:False,False,False
49ers,3,0,14,3,0,20,Rams,0,10,0,3,0,13,2:2006:False:False,False,False
Seahawks,14,0,0,7,0,21,Cardinals,0,0,3,7,0,10,2:2006:False:False,False,False
Chargers,3,17,6,14,0,40,Titans,0,0,0,7,0,7,2:2006:False:False,False,False
Jets,0,0,14,3,0,17,Patriots,7,10,7,0,0,24,2:2006:False:False,False,False
Broncos,0,0,3,3,3,9,Chiefs,0,3,3,0,0,6,2:2006:False:False,False,False
Cowboys,10,7,0,10,0,27,Redskins,0,10,0,0,0,10,2:2006:False:False,False,False
Jaguars,0,0,3,6,0,9,Steelers,0,0,0,0,0,0,2:2006:False:False,False,False
Colts,0,7,7,7,0,21,Jaguars,7,0,0,7,0,14,3:2006:False:False,False,False
Buccaneers,0,7,14,3,0,24,Panthers,10,10,3,3,0,26,3:2006:False:False,False,False
Steelers,7,0,10,3,0,20,Bengals,0,14,0,14,0,28,3:2006:False:False,False,False
Vikings,3,3,0,10,0,16,Bears,3,0,6,10,0,19,3:2006:False:False,False,False
Dolphins,3,0,7,3,0,13,Titans,0,7,3,0,0,10,3:2006:False:False,False,False
Bills,7,3,0,10,0,20,Jets,0,14,7,7,0,28,3:2006:False:False,False,False
Lions,14,0,7,3,0,24,Packers,14,3,7,7,0,31,3:2006:False:False,False,False
Texans,7,0,0,8,0,15,Redskins,7,14,7,3,0,31,3:2006:False:False,False,False
Browns,0,14,0,0,0,14,Ravens,3,0,0,12,0,15,3:2006:False:False,False,False
Cardinals,7,0,0,7,0,14,Rams,0,13,3,0,0,16,3:2006:False:False,False,False
49ers,0,3,7,14,0,24,Eagles,14,10,7,7,0,38,3:2006:False:False,False,False
Seahawks,21,14,7,0,0,42,Giants,0,3,0,27,0,30,3:2006:False:False,False,False
Patriots,0,0,0,7,0,7,Broncos,0,10,0,7,0,17,3:2006:False:False,False,False
Saints,14,6,3,0,0,23,Falcons,3,0,0,0,0,3,3:2006:False:False,False,False
Ravens,7,0,0,9,0,16,Chargers,7,6,0,0,0,13,4:2006:False:False,False,False
Bills,0,7,7,3,0,17,Vikings,3,3,0,6,0,12,4:2006:False:False,False,False
Panthers,7,0,0,14,0,21,Saints,0,3,0,15,0,18,4:2006:False:False,False,False
Texans,0,3,0,14,0,17,Dolphins,0,3,3,9,0,15,4:2006:False:False,False,False
Chiefs,10,14,3,14,0,41,49ers,0,0,0,0,0,0,4:2006:False:False,False,False
Titans,3,3,8,0,0,14,Cowboys,7,7,14,17,0,45,4:2006:False:False,False,False
Falcons,6,6,10,10,0,32,Cardinals,3,7,0,0,0,10,4:2006:False:False,False,False
Jets,0,14,0,14,0,28,Colts,7,7,0,17,0,31,4:2006:False:False,False,False
Rams,13,3,14,11,0,41,Lions,3,14,10,7,0,34,4:2006:False:False,False,False
Bengals,6,0,7,0,0,13,Patriots,0,14,7,17,0,38,4:2006:False:False,False,False
Raiders,7,14,0,0,0,21,Browns,0,10,14,0,0,24,4:2006:False:False,False,False
Redskins,7,6,7,10,6,36,Jaguars,10,7,0,13,0,30,4:2006:False:False,False,False
Bears,7,13,14,3,0,37,Seahawks,3,3,0,0,0,6,4:2006:False:False,False,False
Eagles,0,7,17,7,0,31,Packers,3,6,0,0,0,9,4:2006:False:False,False,False
Bears,6,21,3,10,0,40,Bills,0,0,0,7,0,7,5:2006:False:False,False,False
Packers,7,6,0,7,0,20,Rams,7,7,3,6,0,23,5:2006:False:False,False,False
Colts,0,0,7,7,0,14,Titans,7,3,3,0,0,13,5:2006:False:False,False,False
Vikings,3,0,0,23,0,26,Lions,0,10,7,0,0,17,5:2006:False:False,False,False
Panthers,7,7,3,3,0,20,Browns,3,0,3,6,0,12,5:2006:False:False,False,False
Patriots,3,10,0,7,0,20,Dolphins,0,10,0,0,0,10,5:2006:False:False,False,False
Giants,0,9,7,3,0,19,Redskins,3,0,0,0,0,3,5:2006:False:False,False,False
Saints,3,7,7,7,0,24,Buccaneers,7,0,7,7,0,21,5:2006:False:False,False,False
Cardinals,14,3,3,0,0,20,Chiefs,0,10,0,13,0,23,5:2006:False:False,False,False
Jaguars,14,14,10,3,0,41,Jets,0,0,0,0,0,0,5:2006:False:False,False,False
49ers,7,0,14,13,0,34,Raiders,3,10,0,7,0,20,5:2006:False:False,False,False
Eagles,10,7,7,14,0,38,Cowboys,7,14,0,3,0,24,5:2006:False:False,False,False
Chargers,0,7,10,6,0,23,Steelers,7,6,0,0,0,13,5:2006:False:False,False,False
Broncos,0,3,0,10,0,13,Ravens,3,0,0,0,0,3,5:2006:False:False,False,False
Ravens,0,7,0,14,0,21,Panthers,3,10,0,10,0,23,6:2006:False:False,False,False
Cowboys,0,3,14,17,0,34,Texans,3,3,0,0,0,6,6:2006:False:False,False,False
Lions,10,7,0,3,0,20,Bills,0,10,0,7,0,17,6:2006:False:False,False,False
Saints,10,7,0,10,0,27,Eagles,0,3,14,7,0,24,6:2006:False:False,False,False
Rams,7,14,0,7,0,28,Seahawks,7,0,7,16,0,30,6:2006:False:False,False,False
Redskins,7,7,0,8,0,22,Titans,3,10,9,3,0,25,6:2006:False:False,False,False
Falcons,0,7,7,0,0,14,Giants,0,3,14,10,0,27,6:2006:False:False,False,False
Buccaneers,0,0,7,7,0,14,Bengals,0,7,3,3,0,13,6:2006:False:False,False,False
Steelers,14,17,0,14,0,45,Chiefs,0,0,7,0,0,7,6:2006:False:False,False,False
49ers,7,12,0,0,0,19,Chargers,14,21,3,10,0,48,6:2006:False:False,False,False
Jets,3,0,10,7,0,20,Dolphins,0,0,3,14,0,17,6:2006:False:False,False,False
Broncos,7,6,0,0,0,13,Raiders,0,0,3,0,0,3,6:2006:False:False,False,False
Cardinals,14,6,3,0,0,23,Bears,0,0,10,14,0,24,6:2006:False:False,False,False
Texans,0,10,0,17,0,27,Jaguars,0,0,7,0,0,7,7:2006:False:False,False,False
Buccaneers,0,7,10,6,0,23,Eagles,0,0,7,14,0,21,7:2006:False:False,False,False
Jets,14,7,0,10,0,31,Lions,0,7,3,14,0,24,7:2006:False:False,False,False
Dolphins,7,3,3,11,0,24,Packers,0,6,14,14,0,34,7:2006:False:False,False,False
Falcons,7,14,14,3,3,41,Steelers,10,14,7,7,0,38,7:2006:False:False,False,False
Bills,3,0,0,3,0,6,Patriots,14,0,7,7,0,28,7:2006:False:False,False,False
Bengals,0,7,3,7,0,17,Panthers,7,7,0,0,0,14,7:2006:False:False,False,False
Chiefs,14,6,7,3,0,30,Chargers,0,6,7,14,0,27,7:2006:False:False,False,False
Browns,0,0,0,7,0,7,Broncos,0,10,7,0,0,17,7:2006:False:False,False,False
Colts,7,6,20,3,0,36,Redskins,0,14,0,8,0,22,7:2006:False:False,False,False
Raiders,14,3,5,0,0,22,Cardinals,0,3,3,3,0,9,7:2006:False:False,False,False
Seahawks,7,3,0,3,0,13,Vikings,3,7,14,7,0,31,7:2006:False:False,False,False
Cowboys,0,7,0,15,0,22,Giants,9,3,14,10,0,36,7:2006:False:False,False,False
Bengals,7,10,3,7,0,27,Falcons,6,7,13,3,0,29,8:2006:False:False,False,False
Packers,7,14,7,3,0,31,Cardinals,0,7,7,0,0,14,8:2006:False:False,False,False
Chiefs,10,10,7,8,0,35,Seahawks,7,7,7,7,0,28,8:2006:False:False,False,False
Saints,0,7,0,15,0,22,Ravens,7,21,7,0,0,35,8:2006:False:False,False,False
Giants,7,7,0,3,0,17,Buccaneers,0,3,0,0,0,3,8:2006:False:False,False,False
Titans,0,14,7,7,0,28,Texans,0,3,7,12,0,22,8:2006:False:False,False,False
Bears,24,17,0,0,0,41,49ers,0,0,0,10,0,10,8:2006:False:False,False,False
Eagles,0,0,3,3,0,6,Jaguars,7,0,3,3,0,13,8:2006:False:False,False,False
Chargers,14,0,10,14,0,38,Rams,0,7,3,14,0,24,8:2006:False:False,False,False
Browns,3,7,10,0,0,20,Jets,3,0,7,3,0,13,8:2006:False:False,False,False
Broncos,0,14,7,10,0,31,Colts,3,3,14,14,0,34,8:2006:False:False,False,False
Raiders,7,3,3,7,0,20,Steelers,0,6,0,7,0,13,8:2006:False:False,False,False
Panthers,14,0,0,0,0,14,Cowboys,0,10,0,25,0,35,8:2006:False:False,False,False
Vikings,0,0,7,0,0,7,Patriots,7,10,14,0,0,31,8:2006:False:False,False,False
Redskins,5,7,0,10,0,22,Cowboys,0,12,7,0,0,19,9:2006:False:False,False,False
Jaguars,14,6,17,0,0,37,Titans,0,0,0,7,0,7,9:2006:False:False,False,False
Bears,3,7,3,0,0,13,Dolphins,0,14,7,10,0,31,9:2006:False:False,False,False
Bills,3,7,0,14,0,24,Packers,0,0,7,3,0,10,9:2006:False:False,False,False
Ravens,14,3,6,3,0,26,Bengals,0,7,3,10,0,20,9:2006:False:False,False,False
Lions,10,7,3,10,0,30,Falcons,7,7,0,0,0,14,9:2006:False:False,False,False
Buccaneers,0,14,0,0,0,14,Saints,14,3,14,0,0,31,9:2006:False:False,False,False
Giants,7,0,0,7,0,14,Texans,0,3,7,0,0,10,9:2006:False:False,False,False
Rams,0,10,7,0,0,17,Chiefs,7,17,0,7,0,31,9:2006:False:False,False,False
49ers,0,6,0,3,0,9,Vikings,3,0,0,0,0,3,9:2006:False:False,False,False
Chargers,3,7,7,15,0,32,Browns,3,9,0,13,0,25,9:2006:False:False,False,False
Steelers,0,10,7,3,0,20,Broncos,14,0,7,10,0,31,9:2006:False:False,False,False
Patriots,0,14,3,3,0,20,Colts,7,10,7,3,0,27,9:2006:False:False,False,False
Seahawks,10,3,0,3,0,16,Raiders,0,0,0,0,0,0,9:2006:False:False,False,False
Lions,0,3,7,3,0,13,49ers,10,3,3,3,0,19,10:2006:False:False,False,False
Colts,0,10,7,0,0,17,Bills,3,7,3,3,0,16,10:2006:False:False,False,False
Jaguars,0,3,0,7,0,10,Texans,10,0,3,0,0,13,10:2006:False:False,False,False
Dolphins,3,10,0,0,0,13,Chiefs,0,0,0,10,0,10,10:2006:False:False,False,False
Vikings,0,14,0,3,0,17,Packers,10,7,3,3,0,23,10:2006:False:False,False,False
Patriots,0,6,0,8,0,14,Jets,0,7,3,7,0,17,10:2006:False:False,False,False
Falcons,0,3,7,3,0,13,Browns,7,7,0,3,0,17,10:2006:False:False,False,False
Bengals,21,7,10,3,0,41,Chargers,0,7,21,21,0,49,10:2006:False:False,False,False
Titans,12,14,0,0,0,26,Ravens,7,10,0,10,0,27,10:2006:False:False,False,False
Eagles,10,7,10,0,0,27,Redskins,0,3,0,0,0,3,10:2006:False:False,False,False
Raiders,7,6,0,0,0,13,Broncos,7,0,0,10,0,17,10:2006:False:False,False,False
Seahawks,7,7,0,10,0,24,Rams,10,3,3,6,0,22,10:2006:False:False,False,False
Steelers,14,3,7,14,0,38,Saints,7,17,0,7,0,31,10:2006:False:False,False,False
Cardinals,0,3,0,7,0,10,Cowboys,3,10,7,7,0,27,10:2006:False:False,False,False
Giants,7,6,7,0,0,20,Bears,3,7,14,14,0,38,10:2006:False:False,False,False
Panthers,0,0,17,7,0,24,Buccaneers,7,0,0,3,0,10,10:2006:False:False,False,False
Browns,0,10,0,10,0,20,Steelers,0,0,3,21,0,24,11:2006:False:False,False,False
Ravens,0,0,17,7,0,24,Falcons,7,0,3,0,0,10,11:2006:False:False,False,False
Panthers,0,10,3,2,0,15,Rams,0,0,0,0,0,0,11:2006:False:False,False,False
Buccaneers,3,0,7,10,0,20,Redskins,3,0,7,7,0,17,11:2006:False:False,False,False
Eagles,3,3,0,7,0,13,Titans,7,3,14,7,0,31,11:2006:False:False,False,False
Jets,0,0,0,0,0,0,Bears,0,0,3,7,0,10,11:2006:False:False,False,False
Packers,0,0,0,0,0,0,Patriots,7,14,7,7,0,35,11:2006:False:False,False,False
Texans,7,7,7,0,0,21,Bills,14,3,0,7,0,24,11:2006:False:False,False,False
Chiefs,7,0,3,7,0,17,Raiders,3,10,0,0,0,13,11:2006:False:False,False,False
Dolphins,0,10,0,14,0,24,Vikings,7,0,3,10,0,20,11:2006:False:False,False,False
Saints,7,0,0,9,0,16,Bengals,7,3,0,21,0,31,11:2006:False:False,False,False
Cardinals,0,10,7,0,0,17,Lions,0,0,3,7,0,10,11:2006:False:False,False,False
49ers,3,17,0,0,0,20,Seahawks,0,0,7,7,0,14,11:2006:False:False,False,False
Cowboys,0,0,7,14,0,21,Colts,0,7,7,0,0,14,11:2006:False:False,False,False
Broncos,0,14,10,3,0,27,Chargers,7,0,14,14,0,35,11:2006:False:False,False,False
Jaguars,3,7,6,10,0,26,Giants,3,0,7,0,0,10,11:2006:False:False,False,False
Lions,10,0,0,0,0,10,Dolphins,7,7,10,3,0,27,12:2006:False:False,False,False
Cowboys,7,14,14,3,0,38,Buccaneers,7,3,0,0,0,10,12:2006:False:False,False,False
Chiefs,3,7,3,6,0,19,Broncos,0,3,7,0,0,10,12:2006:False:False,False,False
Bills,7,10,7,3,0,27,Jaguars,0,14,0,10,0,24,12:2006:False:False,False,False
Browns,0,0,0,0,0,0,Bengals,7,10,6,7,0,30,12:2006:False:False,False,False
Falcons,3,3,7,0,0,13,Saints,14,7,0,10,0,31,12:2006:False:False,False,False
Ravens,7,10,7,3,0,27,Steelers,0,0,0,0,0,0,12:2006:False:False,False,False
Redskins,0,3,7,7,0,17,Panthers,3,3,0,7,0,13,12:2006:False:False,False,False
Rams,0,13,0,7,0,20,49ers,0,7,7,3,0,17,12:2006:False:False,False,False
Jets,3,6,14,3,0,26,Texans,0,3,0,8,0,11,12:2006:False:False,False,False
Vikings,7,7,10,7,0,31,Cardinals,7,6,0,13,0,26,12:2006:False:False,False,False
Chargers,0,7,0,14,0,21,Raiders,0,7,7,0,0,14,12:2006:False:False,False,False
Titans,0,0,0,24,0,24,Giants,7,14,0,0,0,21,12:2006:False:False,False,False
Patriots,0,10,0,7,0,17,Bears,0,3,0,10,0,13,12:2006:False:False,False,False
Colts,7,17,7,14,0,45,Eagles,0,7,7,7,0,21,12:2006:False:False,False,False
Seahawks,3,9,7,15,0,34,Packers,7,7,7,3,0,24,12:2006:False:False,False,False
Bengals,0,6,7,0,0,13,Ravens,0,0,0,7,0,7,13:2006:False:False,False,False
Bills,0,0,14,7,0,21,Chargers,10,7,0,7,0,24,13:2006:False:False,False,False
Redskins,14,0,0,0,0,14,Falcons,0,10,7,7,0,24,13:2006:False:False,False,False
Titans,0,10,0,10,0,20,Colts,7,7,0,3,0,17,13:2006:False:False,False,False
Rams,3,0,7,10,0,20,Cardinals,7,10,7,10,0,34,13:2006:False:False,False,False
Saints,0,14,10,10,0,34,49ers,3,0,7,0,0,10,13:2006:False:False,False,False
Patriots,3,10,0,15,0,28,Lions,0,10,8,3,0,21,13:2006:False:False,False,False
Bears,0,7,14,2,0,23,Vikings,0,3,3,7,0,13,13:2006:False:False,False,False
Browns,7,7,0,14,3,31,Chiefs,0,14,7,7,0,28,13:2006:False:False,False,False
Packers,0,0,10,0,0,10,Jets,10,21,0,7,0,38,13:2006:False:False,False,False
Giants,7,0,3,10,0,20,Cowboys,7,3,3,10,0,23,13:2006:False:False,False,False
Dolphins,7,0,0,3,0,10,Jaguars,3,14,0,7,0,24,13:2006:False:False,False,False
Raiders,0,14,0,0,0,14,Texans,7,0,7,9,0,23,13:2006:False:False,False,False
Steelers,7,3,0,10,0,20,Buccaneers,0,0,0,3,0,3,13:2006:False:False,False,False
Broncos,3,10,0,7,0,20,Seahawks,0,7,0,16,0,23,13:2006:False:False,False,False
Eagles,0,7,7,13,0,27,Panthers,7,7,7,3,0,24,13:2006:False:False,False,False
Steelers,7,3,14,3,0,27,Browns,0,0,0,7,0,7,14:2006:False:False,False,False
Panthers,0,10,0,3,0,13,Giants,3,14,10,0,0,27,14:2006:False:False,False,False
Redskins,3,3,10,3,0,19,Eagles,7,14,0,0,0,21,14:2006:False:False,False,False
Buccaneers,3,3,0,0,0,6,Falcons,0,0,14,3,0,17,14:2006:False:False,False,False
Dolphins,3,3,7,8,0,21,Patriots,0,0,0,0,0,0,14:2006:False:False,False,False
Chiefs,0,0,3,7,0,10,Ravens,3,3,7,7,0,20,14:2006:False:False,False,False
Jaguars,7,17,13,7,0,44,Colts,3,7,0,7,0,17,14:2006:False:False,False,False
Bengals,14,0,13,0,0,27,Raiders,0,3,0,7,0,10,14:2006:False:False,False,False
Lions,0,10,3,7,0,20,Vikings,14,6,3,7,0,30,14:2006:False:False,False,False
Texans,0,7,7,6,0,20,Titans,3,3,7,7,6,26,14:2006:False:False,False,False
49ers,3,3,7,6,0,19,Packers,7,10,7,6,0,30,14:2006:False:False,False,False
Cardinals,14,3,0,10,0,27,Seahawks,7,7,7,0,0,21,14:2006:False:False,False,False
Jets,7,6,0,0,0,13,Bills,7,14,7,3,0,31,14:2006:False:False,False,False
Chargers,14,14,0,20,0,48,Broncos,0,3,17,0,0,20,14:2006:False:False,False,False
Cowboys,7,0,10,0,0,17,Saints,0,21,21,0,0,42,14:2006:False:False,False,False
Rams,0,13,0,14,0,27,Bears,0,14,14,14,0,42,14:2006:False:False,False,False
Seahawks,7,0,0,7,0,14,49ers,0,3,0,21,0,24,15:2006:False:False,False,False
Falcons,0,21,7,0,0,28,Cowboys,7,14,10,7,0,38,15:2006:False:False,False,False
Bills,0,7,7,7,0,21,Dolphins,0,0,0,0,0,0,15:2006:False:False,False,False
Titans,7,0,17,0,0,24,Jaguars,7,3,0,7,0,17,15:2006:False:False,False,False
Patriots,17,10,7,6,0,40,Texans,0,0,7,0,0,7,15:2006:False:False,False,False
Vikings,7,0,0,6,0,13,Jets,7,16,3,0,0,26,15:2006:False:False,False,False
Packers,3,7,0,7,0,17,Lions,3,0,3,3,0,9,15:2006:False:False,False,False
Bears,7,14,3,7,3,34,Buccaneers,0,3,7,21,0,31,15:2006:False:False,False,False
Saints,0,7,0,3,0,10,Redskins,10,3,0,3,0,16,15:2006:False:False,False,False
Ravens,7,10,7,3,0,27,Browns,3,7,7,0,0,17,15:2006:False:False,False,False
Panthers,0,3,0,0,0,3,Steelers,0,17,10,10,0,37,15:2006:False:False,False,False
Cardinals,0,10,3,7,0,20,Broncos,10,6,7,14,0,37,15:2006:False:False,False,False
Giants,7,3,3,9,0,22,Eagles,7,7,0,22,0,36,15:2006:False:False,False,False
Raiders,0,0,0,0,0,0,Rams,0,6,7,7,0,20,15:2006:False:False,False,False
Chargers,7,7,0,6,0,20,Chiefs,0,3,3,3,0,9,15:2006:False:False,False,False
Colts,3,14,14,3,0,34,Bengals,3,7,3,3,0,16,15:2006:False:False,False,False
Packers,3,3,0,3,0,9,Vikings,0,0,7,0,0,7,16:2006:False:False,False,False
Raiders,3,3,3,0,0,9,Chiefs,10,7,0,3,0,20,16:2006:False:False,False,False
Steelers,0,7,0,0,0,7,Ravens,7,7,7,10,0,31,16:2006:False:False,False,False
Giants,7,0,0,0,0,7,Saints,3,10,7,10,0,30,16:2006:False:False,False,False
Falcons,3,0,0,0,0,3,Panthers,0,10,0,0,0,10,16:2006:False:False,False,False
Texans,14,7,0,6,0,27,Colts,7,7,3,7,0,24,16:2006:False:False,False,False
Browns,0,0,0,7,0,7,Buccaneers,3,3,6,10,0,22,16:2006:False:False,False,False
Rams,0,14,14,3,6,37,Redskins,7,14,7,3,0,31,16:2006:False:False,False,False
Jaguars,0,7,7,7,0,21,Patriots,0,10,7,7,0,24,16:2006:False:False,False,False
Bills,10,9,10,0,0,29,Titans,7,13,0,10,0,30,16:2006:False:False,False,False
Lions,7,0,14,0,0,21,Bears,3,14,0,9,0,26,16:2006:False:False,False,False
49ers,3,3,7,7,0,20,Cardinals,10,10,0,6,0,26,16:2006:False:False,False,False
Seahawks,0,0,7,10,0,17,Chargers,0,7,6,7,0,20,16:2006:False:False,False,False
Broncos,0,14,7,3,0,24,Bengals,7,10,0,6,0,23,16:2006:False:False,False,False
Cowboys,0,7,0,0,0,7,Eagles,7,6,3,7,0,23,16:2006:False:False,False,False
Dolphins,0,0,0,10,0,10,Jets,0,0,3,10,0,13,16:2006:False:False,False,False
Redskins,7,0,7,14,0,28,Giants,3,17,7,7,0,34,17:2006:False:False,False,False
Texans,0,0,14,0,0,14,Browns,0,3,0,3,0,6,17:2006:False:False,False,False
Buccaneers,0,7,0,0,0,7,Seahawks,10,7,3,3,0,23,17:2006:False:False,False,False
Jets,7,3,3,10,0,23,Raiders,0,3,0,0,0,3,17:2006:False:False,False,False
Saints,7,7,7,0,0,21,Panthers,7,7,14,3,0,31,17:2006:False:False,False,False
Vikings,7,0,0,14,0,21,Rams,10,14,10,7,0,41,17:2006:False:False,False,False
Chiefs,7,14,14,0,0,35,Jaguars,0,10,14,6,0,30,17:2006:False:False,False,False
Titans,3,7,13,0,0,23,Patriots,9,10,7,14,0,40,17:2006:False:False,False,False
Bengals,0,3,0,14,0,17,Steelers,0,7,0,10,6,23,17:2006:False:False,False,False
Cowboys,0,14,10,7,0,31,Lions,13,7,10,9,0,39,17:2006:False:False,False,False
Colts,0,17,3,7,0,27,Dolphins,3,3,6,10,0,22,17:2006:False:False,False,False
Chargers,3,14,10,0,0,27,Cardinals,7,0,3,10,0,20,17:2006:False:False,False,False
Broncos,3,10,3,7,0,23,49ers,0,3,14,6,3,26,17:2006:False:False,False,False
Eagles,10,7,0,7,0,24,Falcons,7,3,0,7,0,17,17:2006:False:False,False,False
Ravens,3,3,10,3,0,19,Bills,0,0,7,0,0,7,17:2006:False:False,False,False
Bears,0,0,7,0,0,7,Packers,13,10,0,3,0,26,17:2006:False:False,False,False
Colts,6,3,7,7,0,23,Chiefs,0,0,8,0,0,8,18:2006:False:True,False,True
Seahawks,3,3,7,8,0,21,Cowboys,3,7,7,3,0,20,18:2006:False:True,False,True
Patriots,7,10,6,14,0,37,Jets,3,7,3,3,0,16,18:2006:False:True,False,True
Eagles,0,17,3,3,0,23,Giants,7,3,0,10,0,20,18:2006:False:True,False,True
Ravens,0,3,0,3,0,6,Colts,6,3,3,3,0,15,19:2006:False:True,False,True
Saints,3,10,14,0,0,27,Eagles,0,14,7,3,0,24,19:2006:False:True,False,True
Bears,7,14,0,3,3,27,Seahawks,0,14,10,0,0,24,19:2006:False:True,False,True
Chargers,0,14,0,7,0,21,Patriots,3,7,3,11,0,24,19:2006:False:True,False,True
Bears,3,13,2,21,0,39,Saints,0,7,7,0,0,14,20:2006:False:True,False,True
Colts,3,3,15,17,0,38,Patriots,7,14,7,6,0,34,20:2006:False:True,False,True
Bears,14,0,3,0,0,17,Colts,6,10,6,7,0,29,21:2006:False:True,False,True
Lions,0,10,0,17,0,27,Bengals,6,10,3,7,0,26,1:2007:True:False,True,False
Cowboys,3,3,14,3,0,23,Colts,3,0,0,7,0,10,1:2007:True:False,True,False
Jets,0,14,14,3,0,31,Falcons,7,6,0,3,0,16,1:2007:True:False,True,False
Buccaneers,0,10,0,3,0,13,Patriots,0,7,0,3,0,10,1:2007:True:False,True,False
Vikings,0,3,7,0,0,10,Rams,0,7,0,6,0,13,1:2007:True:False,True,False
Saints,0,3,0,7,0,10,Bills,0,3,7,3,0,13,1:2007:True:False,True,False
Steelers,6,3,0,0,0,9,Packers,0,3,10,0,0,13,1:2007:True:False,True,False
Browns,3,3,3,7,0,16,Chiefs,0,7,0,5,0,12,1:2007:True:False,True,False
Dolphins,0,3,7,8,0,18,Jaguars,0,10,7,0,0,17,1:2007:True:False,True,False
Titans,3,0,0,3,0,6,Redskins,0,0,0,14,0,14,1:2007:True:False,True,False
Giants,7,7,7,0,0,21,Panthers,7,10,7,0,0,24,1:2007:True:False,True,False
Texans,3,9,7,0,0,19,Bears,0,7,0,13,0,20,1:2007:True:False,True,False
Raiders,0,21,0,6,0,27,Cardinals,0,10,13,0,0,23,1:2007:True:False,True,False
Chargers,0,7,6,3,0,16,Seahawks,7,0,0,17,0,24,1:2007:True:False,True,False
Ravens,7,6,3,13,0,29,Eagles,0,3,0,0,0,3,1:2007:True:False,True,False
49ers,10,3,0,0,0,13,Broncos,7,7,3,0,0,17,1:2007:True:False,True,False
Chiefs,0,7,0,3,0,10,Dolphins,0,3,0,8,0,11,2:2007:True:False,True,False
Eagles,10,14,3,0,0,27,Panthers,0,3,0,7,0,10,2:2007:True:False,True,False
Bills,0,3,7,0,0,10,Falcons,0,6,0,7,0,13,2:2007:True:False,True,False
Patriots,14,3,0,7,0,24,Titans,7,0,10,10,0,27,2:2007:True:False,True,False
Jets,3,10,0,7,0,20,Vikings,14,10,10,3,0,37,2:2007:True:False,True,False
Cardinals,0,10,3,7,0,20,Texans,7,6,17,3,0,33,2:2007:True:False,True,False
Browns,0,0,0,20,0,20,Lions,3,13,7,0,0,23,2:2007:True:False,True,False
Jaguars,0,24,0,7,0,31,Buccaneers,7,0,0,12,0,19,2:2007:True:False,True,False
Bengals,3,9,0,7,0,19,Saints,10,7,0,10,0,27,2:2007:True:False,True,False
Cowboys,14,10,0,7,0,31,Broncos,0,6,7,7,0,20,2:2007:True:False,True,False
Rams,0,3,3,7,0,13,Chargers,7,7,0,16,0,30,2:2007:True:False,True,False
Packers,10,28,10,0,0,48,Seahawks,3,10,0,0,0,13,2:2007:True:False,True,False
Redskins,7,0,3,0,0,10,Steelers,0,3,0,9,0,12,2:2007:True:False,True,False
49ers,13,0,7,6,0,26,Raiders,0,14,7,0,0,21,2:2007:True:False,True,False
Ravens,3,3,0,6,0,12,Giants,0,7,0,6,0,13,2:2007:True:False,True,False
Colts,0,17,0,7,0,24,Bears,0,17,10,0,0,27,2:2007:True:False,True,False
Packers,0,10,0,3,0,13,Jaguars,0,0,14,7,0,21,3:2007:True:False,True,False
Chiefs,0,0,0,7,0,7,Saints,0,13,0,17,0,30,3:2007:True:False,True,False
Bills,0,10,0,7,0,17,Titans,0,14,14,0,0,28,3:2007:True:False,True,False
Panthers,0,7,0,0,0,7,Patriots,3,7,14,0,0,24,3:2007:True:False,True,False
Raiders,3,14,3,0,0,20,Rams,0,3,0,7,0,10,3:2007:True:False,True,False
Colts,7,14,6,10,0,37,Lions,0,3,0,7,0,10,3:2007:True:False,True,False
Dolphins,14,0,7,7,0,28,Buccaneers,7,10,0,14,0,31,3:2007:True:False,True,False
Redskins,3,3,7,0,0,13,Ravens,0,7,0,0,0,7,3:2007:True:False,True,False
Bears,10,21,0,0,0,31,49ers,0,13,0,15,0,28,3:2007:True:False,True,False
Giants,0,12,0,0,0,12,Jets,6,0,14,0,0,20,3:2007:True:False,True,False
Texans,7,14,0,7,0,28,Cowboys,0,6,7,3,0,16,3:2007:True:False,True,False
Broncos,3,7,0,6,0,16,Browns,7,3,7,0,0,17,3:2007:True:False,True,False
Seahawks,6,10,7,7,0,30,Vikings,0,10,3,0,0,13,3:2007:True:False,True,False
Cardinals,10,7,7,7,0,31,Chargers,10,7,10,6,0,33,3:2007:True:False,True,False
Steelers,0,13,7,7,0,27,Eagles,3,0,3,7,0,13,3:2007:True:False,True,False
Falcons,7,7,10,0,0,24,Bengals,0,13,0,6,0,19,3:2007:True:False,True,False
Lions,3,10,0,0,0,13,Bills,0,3,7,6,0,16,4:2007:True:False,True,False
Jaguars,0,10,14,7,0,31,Redskins,7,7,0,0,0,14,4:2007:True:False,True,False
Eagles,0,3,0,8,0,11,Jets,0,3,0,10,0,13,4:2007:True:False,True,False
Patriots,3,7,7,10,0,27,Giants,7,0,3,10,0,20,4:2007:True:False,True,False
Panthers,0,3,0,0,0,3,Steelers,0,3,6,10,0,19,4:2007:True:False,True,False
Rams,3,0,7,0,0,10,Chiefs,0,0,0,3,0,3,4:2007:True:False,True,False
Saints,7,0,0,0,0,7,Dolphins,0,0,0,0,0,0,4:2007:True:False,True,False
Buccaneers,7,17,0,7,0,31,Texans,14,3,7,0,0,24,4:2007:True:False,True,False
Bears,0,3,6,0,0,9,Browns,5,14,0,0,0,19,4:2007:True:False,True,False
Vikings,0,17,3,3,0,23,Cowboys,7,7,0,0,0,14,4:2007:True:False,True,False
Titans,0,14,13,3,0,30,Packers,7,0,7,0,0,14,4:2007:True:False,True,False
Broncos,0,7,7,7,0,21,Cardinals,3,0,0,0,0,3,4:2007:True:False,True,False
Seahawks,3,9,0,7,0,19,Raiders,7,0,7,0,0,14,4:2007:True:False,True,False
Chargers,3,10,0,3,0,16,49ers,0,3,0,10,0,13,4:2007:True:False,True,False
Falcons,7,0,0,6,0,13,Ravens,7,0,3,0,0,10,4:2007:True:False,True,False
Bengals,0,0,14,0,0,14,Colts,0,0,0,6,0,6,4:2007:True:False,True,False
Colts,7,3,14,17,0,41,Saints,0,10,0,0,0,10,1:2007:False:False,False,False
Texans,0,10,7,3,0,20,Chiefs,0,0,3,0,0,3,1:2007:False:False,False,False
Vikings,7,0,3,14,0,24,Falcons,0,0,0,3,0,3,1:2007:False:False,False,False
Jets,0,7,7,0,0,14,Patriots,7,7,14,10,0,38,1:2007:False:False,False,False
Rams,7,3,3,0,0,13,Panthers,7,0,7,13,0,27,1:2007:False:False,False,False
Redskins,0,3,7,3,3,16,Dolphins,0,7,3,3,0,13,1:2007:False:False,False,False
Packers,10,0,3,3,0,16,Eagles,0,10,3,0,0,13,1:2007:False:False,False,False
Browns,0,0,7,0,0,7,Steelers,17,0,14,3,0,34,1:2007:False:False,False,False
Bills,7,0,7,0,0,14,Broncos,3,3,6,3,0,15,1:2007:False:False,False,False
Jaguars,7,3,0,0,0,10,Titans,3,3,7,0,0,13,1:2007:False:False,False,False
Seahawks,0,10,0,10,0,20,Buccaneers,6,0,0,0,0,6,1:2007:False:False,False,False
Chargers,0,0,7,7,0,14,Bears,0,3,0,0,0,3,1:2007:False:False,False,False
Raiders,0,0,14,7,0,21,Lions,0,10,7,19,0,36,1:2007:False:False,False,False
Cowboys,3,14,14,14,0,45,Giants,6,10,3,16,0,35,1:2007:False:False,False,False
Bengals,9,3,7,8,0,27,Ravens,0,10,0,10,0,20,1:2007:False:False,False,False
49ers,7,3,3,7,0,20,Cardinals,0,10,0,7,0,17,1:2007:False:False,False,False
Jaguars,0,3,0,10,0,13,Falcons,0,7,0,0,0,7,2:2007:False:False,False,False
Giants,0,10,3,0,0,13,Packers,0,7,7,21,0,35,2:2007:False:False,False,False
Steelers,3,9,7,7,0,26,Bills,0,0,3,0,0,3,2:2007:False:False,False,False
Rams,7,6,0,3,0,16,49ers,0,7,7,3,0,17,2:2007:False:False,False,False
Buccaneers,7,14,7,3,0,31,Saints,0,0,7,7,0,14,2:2007:False:False,False,False
Titans,3,3,7,7,0,20,Colts,6,10,6,0,0,22,2:2007:False:False,False,False
Panthers,14,0,0,7,0,21,Texans,7,10,14,3,0,34,2:2007:False:False,False,False
Browns,6,21,14,10,0,51,Bengals,7,14,17,7,0,45,2:2007:False:False,False,False
Lions,0,10,7,0,3,20,Vikings,0,7,10,0,0,17,2:2007:False:False,False,False
Dolphins,3,3,7,7,0,20,Cowboys,3,7,10,17,0,37,2:2007:False:False,False,False
Cardinals,3,14,0,6,0,23,Seahawks,0,7,10,3,0,20,2:2007:False:False,False,False
Ravens,7,10,0,3,0,20,Jets,0,3,0,10,0,13,2:2007:False:False,False,False
Bears,0,17,3,0,0,20,Chiefs,0,7,3,0,0,10,2:2007:False:False,False,False
Broncos,7,10,0,3,3,23,Raiders,0,3,7,10,0,20,2:2007:False:False,False,False
Patriots,14,10,7,7,0,38,Chargers,0,0,7,7,0,14,2:2007:False:False,False,False
Eagles,0,6,3,3,0,12,Redskins,3,7,3,7,0,20,2:2007:False:False,False,False
Texans,7,3,0,14,0,24,Colts,7,7,13,3,0,30,3:2007:False:False,False,False
Jets,7,14,3,7,0,31,Dolphins,0,13,0,15,0,28,3:2007:False:False,False,False
Eagles,21,21,7,7,0,56,Lions,7,14,0,0,0,21,3:2007:False:False,False,False
Steelers,7,7,3,20,0,37,49ers,6,0,3,7,0,16,3:2007:False:False,False,False
Buccaneers,0,3,7,14,0,24,Rams,0,0,0,3,0,3,3:2007:False:False,False,False
Chiefs,0,3,3,7,0,13,Vikings,7,3,0,0,0,10,3:2007:False:False,False,False
Patriots,3,14,14,7,0,38,Bills,7,0,0,0,0,7,3:2007:False:False,False,False
Packers,3,14,0,14,0,31,Chargers,7,7,7,3,0,24,3:2007:False:False,False,False
Ravens,3,17,3,3,0,26,Cardinals,0,3,3,17,0,23,3:2007:False:False,False,False
Broncos,0,7,0,7,0,14,Jaguars,0,17,3,3,0,23,3:2007:False:False,False,False
Seahawks,7,7,0,10,0,24,Bengals,7,3,2,9,0,21,3:2007:False:False,False,False
Raiders,3,13,7,3,0,26,Browns,0,10,7,7,0,24,3:2007:False:False,False,False
Redskins,7,10,0,0,0,17,Giants,3,0,7,14,0,24,3:2007:False:False,False,False
Falcons,0,10,7,3,0,20,Panthers,0,10,14,3,0,27,3:2007:False:False,False,False
Bears,3,0,7,0,0,10,Cowboys,0,3,14,17,0,34,3:2007:False:False,False,False
Saints,0,7,7,0,0,14,Titans,3,7,7,14,0,31,3:2007:False:False,False,False
Bills,0,0,7,10,0,17,Jets,0,0,7,7,0,14,4:2007:False:False,False,False
Browns,14,10,3,0,0,27,Ravens,0,6,0,7,0,13,4:2007:False:False,False,False
Cowboys,0,14,21,0,0,35,Rams,0,7,0,0,0,7,4:2007:False:False,False,False
Lions,3,0,0,34,0,37,Bears,0,7,6,14,0,27,4:2007:False:False,False,False
Dolphins,0,7,10,0,0,17,Raiders,14,0,7,14,0,35,4:2007:False:False,False,False
Falcons,10,10,3,3,0,26,Texans,7,3,3,3,0,16,4:2007:False:False,False,False
Vikings,0,6,3,7,0,16,Packers,7,3,3,10,0,23,4:2007:False:False,False,False
49ers,0,0,3,0,0,3,Seahawks,0,13,7,3,0,23,4:2007:False:False,False,False
Panthers,0,0,0,7,0,7,Buccaneers,14,3,0,3,0,20,4:2007:False:False,False,False
Cardinals,0,0,7,14,0,21,Steelers,7,0,0,7,0,14,4:2007:False:False,False,False
Colts,0,14,14,10,0,38,Broncos,10,3,7,0,0,20,4:2007:False:False,False,False
Chargers,10,6,0,0,0,16,Chiefs,0,6,10,14,0,30,4:2007:False:False,False,False
Giants,0,7,9,0,0,16,Eagles,0,0,0,3,0,3,4:2007:False:False,False,False
Bengals,0,7,3,3,0,13,Patriots,10,7,7,10,0,34,4:2007:False:False,False,False
Chiefs,0,0,0,7,0,7,Jaguars,3,7,0,7,0,17,5:2007:False:False,False,False
Patriots,10,10,0,14,0,34,Browns,0,0,3,14,0,17,5:2007:False:False,False,False
Saints,3,3,7,0,0,13,Panthers,3,3,0,10,0,16,5:2007:False:False,False,False
Giants,0,7,14,14,0,35,Jets,7,10,7,0,0,24,5:2007:False:False,False,False
Steelers,0,7,7,7,0,21,Seahawks,0,0,0,0,0,0,5:2007:False:False,False,False
Titans,7,3,10,0,0,20,Falcons,7,3,3,0,0,13,5:2007:False:False,False,False
Redskins,0,14,2,18,0,34,Lions,0,0,3,0,0,3,5:2007:False:False,False,False
Texans,7,3,6,6,0,22,Dolphins,10,6,0,3,0,19,5:2007:False:False,False,False
Rams,3,10,7,11,0,31,Cardinals,3,14,3,14,0,34,5:2007:False:False,False,False
Colts,7,9,7,10,0,33,Buccaneers,0,7,0,7,0,14,5:2007:False:False,False,False
Broncos,0,3,0,0,0,3,Chargers,14,6,14,7,0,41,5:2007:False:False,False,False
49ers,0,0,7,0,0,7,Ravens,0,6,3,0,0,9,5:2007:False:False,False,False
Packers,7,10,3,0,0,20,Bears,0,7,10,10,0,27,5:2007:False:False,False,False
Bills,7,10,7,0,0,24,Cowboys,0,10,3,12,0,25,5:2007:False:False,False,False
Bears,7,7,0,17,0,31,Vikings,7,7,7,13,0,34,6:2007:False:False,False,False
Browns,14,13,0,14,0,41,Dolphins,3,7,14,7,0,31,6:2007:False:False,False,False
Packers,7,0,10,0,0,17,Redskins,7,7,0,0,0,14,6:2007:False:False,False,False
Jaguars,0,10,6,21,0,37,Texans,3,3,3,8,0,17,6:2007:False:False,False,False
Chiefs,10,10,0,7,0,27,Bengals,7,0,0,13,0,20,6:2007:False:False,False,False
Buccaneers,0,3,7,3,0,13,Titans,0,0,3,7,0,10,6:2007:False:False,False,False
Ravens,3,10,3,6,0,22,Rams,0,0,3,0,0,3,6:2007:False:False,False,False
Jets,3,3,0,3,0,9,Eagles,7,3,6,0,0,16,6:2007:False:False,False,False
Cardinals,0,7,3,0,0,10,Panthers,3,3,3,16,0,25,6:2007:False:False,False,False
Cowboys,0,17,7,3,0,27,Patriots,14,7,10,17,0,48,6:2007:False:False,False,False
Chargers,14,0,7,7,0,28,Raiders,0,7,0,7,0,14,6:2007:False:False,False,False
Seahawks,0,10,0,7,0,17,Saints,7,21,0,0,0,28,6:2007:False:False,False,False
Falcons,10,0,0,0,0,10,Giants,14,7,0,10,0,31,6:2007:False:False,False,False
Lions,10,3,3,7,0,23,Buccaneers,0,7,0,9,0,16,7:2007:False:False,False,False
Texans,7,0,0,29,0,36,Titans,6,16,10,6,0,38,7:2007:False:False,False,False
Dolphins,0,7,0,21,0,28,Patriots,14,28,0,7,0,49,7:2007:False:False,False,False
Giants,6,13,7,7,0,33,49ers,0,7,2,6,0,15,7:2007:False:False,False,False
Bills,3,6,10,0,0,19,Ravens,0,0,7,7,0,14,7:2007:False:False,False,False
Saints,7,0,7,8,0,22,Falcons,3,10,0,3,0,16,7:2007:False:False,False,False
Redskins,7,7,7,0,0,21,Cardinals,0,6,0,13,0,19,7:2007:False:False,False,False
Bengals,3,7,7,21,0,38,Jets,7,13,3,8,0,31,7:2007:False:False,False,False
Raiders,0,0,7,3,0,10,Chiefs,3,3,0,6,0,12,7:2007:False:False,False,False
Eagles,3,6,0,7,0,16,Bears,0,3,3,13,0,19,7:2007:False:False,False,False
Seahawks,7,3,13,10,0,33,Rams,3,0,3,0,0,6,7:2007:False:False,False,False
Cowboys,7,0,14,3,0,24,Vikings,7,7,0,0,0,14,7:2007:False:False,False,False
Broncos,7,14,7,3,0,31,Steelers,7,0,7,14,0,28,7:2007:False:False,False,False
Jaguars,0,0,7,0,0,7,Colts,7,10,2,10,0,29,7:2007:False:False,False,False
Panthers,7,0,0,0,0,7,Colts,3,7,14,7,0,31,8:2007:False:False,False,False
Rams,14,3,3,0,0,20,Browns,3,14,7,3,0,27,8:2007:False:False,False,False
Vikings,7,3,3,3,0,16,Eagles,3,14,3,3,0,23,8:2007:False:False,False,False
Dolphins,0,0,3,7,0,10,Giants,3,10,0,0,0,13,8:2007:False:False,False,False
Bengals,3,3,0,7,0,13,Steelers,7,14,0,3,0,24,8:2007:False:False,False,False
Titans,3,0,7,3,0,13,Raiders,3,6,0,0,0,9,8:2007:False:False,False,False
Bears,0,0,7,0,0,7,Lions,0,13,0,3,0,16,8:2007:False:False,False,False
Jets,0,3,0,0,0,3,Bills,3,0,0,10,0,13,8:2007:False:False,False,False
Buccaneers,3,10,10,0,0,23,Jaguars,7,10,0,7,0,24,8:2007:False:False,False,False
Chargers,14,21,0,0,0,35,Texans,0,3,0,7,0,10,8:2007:False:False,False,False
49ers,0,0,3,7,0,10,Saints,10,14,0,7,0,31,8:2007:False:False,False,False
Patriots,7,17,14,14,0,52,Redskins,0,0,0,7,0,7,8:2007:False:False,False,False
Broncos,7,0,3,3,0,13,Packers,7,6,0,0,6,19,8:2007:False:False,False,False
Bills,7,6,3,17,0,33,Bengals,7,7,7,0,0,21,9:2007:False:False,False,False
Lions,3,13,14,14,0,44,Broncos,0,0,0,7,0,7,9:2007:False:False,False,False
Chiefs,0,7,0,15,0,22,Packers,0,6,7,20,0,33,9:2007:False:False,False,False
Vikings,7,0,14,14,0,35,Chargers,7,7,0,3,0,17,9:2007:False:False,False,False
Saints,17,7,14,3,0,41,Jaguars,17,0,0,7,0,24,9:2007:False:False,False,False
Buccaneers,7,3,7,0,0,17,Cardinals,3,0,0,7,0,10,9:2007:False:False,False,False
Titans,10,3,0,7,0,20,Panthers,0,0,0,7,0,7,9:2007:False:False,False,False
Falcons,7,7,0,6,0,20,49ers,7,0,6,3,0,16,9:2007:False:False,False,False
Jets,10,7,0,3,0,20,Redskins,3,6,3,8,3,23,9:2007:False:False,False,False
Browns,0,9,7,14,3,33,Seahawks,7,14,3,6,0,30,9:2007:False:False,False,False
Colts,3,10,0,7,0,20,Patriots,0,7,3,14,0,24,9:2007:False:False,False,False
Raiders,0,0,3,14,0,17,Texans,7,10,0,7,0,24,9:2007:False:False,False,False
Eagles,7,0,3,7,0,17,Cowboys,14,7,14,3,0,38,9:2007:False:False,False,False
Steelers,14,21,3,0,0,38,Ravens,0,7,0,0,0,7,9:2007:False:False,False,False
Packers,7,6,14,7,0,34,Vikings,0,0,0,0,0,0,10:2007:False:False,False,False
Chiefs,3,5,3,0,0,11,Broncos,3,3,14,7,0,27,10:2007:False:False,False,False
Dolphins,3,0,7,0,0,10,Bills,0,0,2,11,0,13,10:2007:False:False,False,False
Saints,7,0,0,22,0,29,Rams,7,10,10,10,0,37,10:2007:False:False,False,False
Steelers,3,6,7,15,0,31,Browns,7,14,0,7,0,28,10:2007:False:False,False,False
Redskins,0,12,3,10,0,25,Eagles,7,0,6,20,0,33,10:2007:False:False,False,False
Panthers,0,10,0,3,0,13,Falcons,7,0,3,10,0,20,10:2007:False:False,False,False
Titans,0,3,3,7,0,13,Jaguars,7,7,7,7,0,28,10:2007:False:False,False,False
Ravens,0,0,0,7,0,7,Bengals,0,6,3,12,0,21,10:2007:False:False,False,False
Cardinals,3,14,7,7,0,31,Lions,7,0,7,7,0,21,10:2007:False:False,False,False
Giants,7,10,0,3,0,20,Cowboys,7,10,7,7,0,31,10:2007:False:False,False,False
Raiders,3,0,0,3,0,6,Bears,0,3,0,14,0,17,10:2007:False:False,False,False
Chargers,16,7,0,0,0,23,Colts,0,7,0,14,0,21,10:2007:False:False,False,False
Seahawks,10,7,0,7,0,24,49ers,0,0,0,0,0,0,10:2007:False:False,False,False
Eagles,0,3,7,7,0,17,Dolphins,0,7,0,0,0,7,11:2007:False:False,False,False
Lions,0,0,3,7,0,10,Giants,3,7,3,3,0,16,11:2007:False:False,False,False
Vikings,9,10,3,7,0,29,Raiders,3,16,0,3,0,22,11:2007:False:False,False,False
Jaguars,10,7,7,0,0,24,Chargers,0,3,7,7,0,17,11:2007:False:False,False,False
Colts,0,3,7,3,0,13,Chiefs,0,3,7,0,0,10,11:2007:False:False,False,False
Texans,7,10,0,6,0,23,Saints,3,7,0,0,0,10,11:2007:False:False,False,False
Falcons,0,0,0,7,0,7,Buccaneers,7,7,10,7,0,31,11:2007:False:False,False,False
Ravens,0,7,7,16,0,30,Browns,3,10,14,3,3,33,11:2007:False:False,False,False
Bengals,7,6,14,0,0,27,Cardinals,7,14,14,0,0,35,11:2007:False:False,False,False
Packers,7,14,7,3,0,31,Panthers,3,0,7,7,0,17,11:2007:False:False,False,False
Jets,10,3,0,3,3,19,Steelers,0,7,6,3,0,16,11:2007:False:False,False,False
Cowboys,0,7,7,14,0,28,Redskins,7,3,3,10,0,23,11:2007:False:False,False,False
Seahawks,7,10,7,6,0,30,Bears,10,7,0,6,0,23,11:2007:False:False,False,False
49ers,3,0,0,6,0,9,Rams,7,3,0,3,0,13,11:2007:False:False,False,False
Bills,7,0,3,0,0,10,Patriots,14,21,7,14,0,56,11:2007:False:False,False,False
Broncos,14,6,7,7,0,34,Titans,0,10,7,3,0,20,11:2007:False:False,False,False
Lions,6,3,3,14,0,26,Packers,0,17,14,6,0,37,12:2007:False:False,False,False
Cowboys,7,14,3,10,0,34,Jets,0,3,0,0,0,3,12:2007:False:False,False,False
Falcons,10,3,0,0,0,13,Colts,0,21,10,0,0,31,12:2007:False:False,False,False
Bengals,7,7,14,7,0,35,Titans,0,6,0,0,0,6,12:2007:False:False,False,False
Rams,16,3,0,0,0,19,Seahawks,7,0,10,7,0,24,12:2007:False:False,False,False
Giants,7,0,3,7,0,17,Vikings,14,10,3,14,0,41,12:2007:False:False,False,False
Panthers,3,3,0,0,0,6,Saints,0,10,21,0,0,31,12:2007:False:False,False,False
Buccaneers,10,9,0,0,0,19,Redskins,0,3,7,3,0,13,12:2007:False:False,False,False
Browns,0,14,3,10,0,27,Texans,7,3,0,7,0,17,12:2007:False:False,False,False
Jaguars,10,6,3,17,0,36,Bills,0,7,7,0,0,14,12:2007:False:False,False,False
Chiefs,7,3,7,0,0,17,Raiders,3,3,7,7,0,20,12:2007:False:False,False,False
Cardinals,7,14,0,10,0,31,49ers,7,10,7,7,6,37,12:2007:False:False,False,False
Bears,3,3,14,14,3,37,Broncos,3,10,14,7,0,34,12:2007:False:False,False,False
Chargers,0,22,7,3,0,32,Ravens,0,7,7,0,0,14,12:2007:False:False,False,False
Patriots,14,10,0,7,0,31,Eagles,7,14,7,0,0,28,12:2007:False:False,False,False
Steelers,0,0,0,3,0,3,Dolphins,0,0,0,0,0,0,12:2007:False:False,False,False
Cowboys,13,14,0,10,0,37,Packers,10,7,7,3,0,27,13:2007:False:False,False,False
Rams,14,7,0,7,0,28,Falcons,0,0,3,13,0,16,13:2007:False:False,False,False
Titans,7,0,14,7,0,28,Texans,7,3,0,10,0,20,13:2007:False:False,False,False
Redskins,3,6,7,0,0,16,Bills,0,2,6,9,0,17,13:2007:False:False,False,False
Vikings,7,28,7,0,0,42,Lions,3,7,0,0,0,10,13:2007:False:False,False,False
Eagles,10,7,7,0,0,24,Seahawks,14,7,7,0,0,28,13:2007:False:False,False,False
Dolphins,3,10,0,0,0,13,Jets,7,13,3,17,0,40,13:2007:False:False,False,False
Chiefs,3,7,0,0,0,10,Chargers,3,7,7,7,0,24,13:2007:False:False,False,False
Colts,14,7,0,7,0,28,Jaguars,0,7,7,11,0,25,13:2007:False:False,False,False
Panthers,3,14,7,7,0,31,49ers,0,0,14,0,0,14,13:2007:False:False,False,False
Raiders,7,7,10,10,0,34,Broncos,7,0,6,7,0,20,13:2007:False:False,False,False
Cardinals,14,0,7,6,0,27,Browns,3,7,8,3,0,21,13:2007:False:False,False,False
Saints,7,7,7,2,0,23,Buccaneers,3,10,7,7,0,27,13:2007:False:False,False,False
Bears,7,6,3,0,0,16,Giants,0,7,0,14,0,21,13:2007:False:False,False,False
Steelers,0,17,7,0,0,24,Bengals,7,0,3,0,0,10,13:2007:False:False,False,False
Ravens,7,3,7,7,0,24,Patriots,3,7,7,10,0,27,13:2007:False:False,False,False
Redskins,0,7,7,10,0,24,Bears,0,0,10,6,0,16,14:2007:False:False,False,False
Bengals,7,3,6,3,0,19,Rams,0,0,7,3,0,10,14:2007:False:False,False,False
Lions,10,10,7,0,0,27,Cowboys,0,14,0,14,0,28,14:2007:False:False,False,False
Packers,0,14,17,7,0,38,Raiders,0,7,0,0,0,7,14:2007:False:False,False,False
Bills,24,7,0,7,0,38,Dolphins,7,0,10,0,0,17,14:2007:False:False,False,False
Texans,7,7,7,7,0,28,Buccaneers,0,7,7,0,0,14,14:2007:False:False,False,False
Titans,3,0,7,7,0,17,Chargers,0,0,3,14,6,23,14:2007:False:False,False,False
Jaguars,7,3,10,17,0,37,Panthers,0,6,0,0,0,6,14:2007:False:False,False,False
Eagles,7,0,3,3,0,13,Giants,0,6,10,0,0,16,14:2007:False:False,False,False
Seahawks,10,17,0,15,0,42,Cardinals,0,7,7,7,0,21,14:2007:False:False,False,False
49ers,0,0,7,0,0,7,Vikings,10,17,0,0,0,27,14:2007:False:False,False,False
Patriots,7,10,14,3,0,34,Steelers,3,10,0,0,0,13,14:2007:False:False,False,False
Jets,0,3,3,12,0,18,Browns,0,7,7,10,0,24,14:2007:False:False,False,False
Broncos,14,10,17,0,0,41,Chiefs,0,7,0,0,0,7,14:2007:False:False,False,False
Ravens,0,7,0,13,0,20,Colts,23,14,7,0,0,44,14:2007:False:False,False,False
Falcons,7,0,0,7,0,14,Saints,7,10,14,3,0,34,14:2007:False:False,False,False
Texans,7,3,7,14,0,31,Broncos,0,6,7,0,0,13,15:2007:False:False,False,False
49ers,0,14,6,0,0,20,Bengals,0,10,0,3,0,13,15:2007:False:False,False,False
Rams,7,7,0,0,0,14,Packers,7,10,10,6,0,33,15:2007:False:False,False,False
Browns,3,5,0,0,0,8,Bills,0,0,0,0,0,0,15:2007:False:False,False,False
Buccaneers,14,13,3,7,0,37,Falcons,3,0,0,0,0,3,15:2007:False:False,False,False
Panthers,0,0,0,13,0,13,Seahawks,0,0,0,10,0,10,15:2007:False:False,False,False
Steelers,0,7,0,15,0,22,Jaguars,3,7,12,7,0,29,15:2007:False:False,False,False
Chiefs,0,14,3,0,0,17,Titans,7,3,10,6,0,26,15:2007:False:False,False,False
Dolphins,0,3,7,6,6,22,Ravens,3,10,0,3,0,16,15:2007:False:False,False,False
Patriots,7,10,0,3,0,20,Jets,0,7,0,3,0,10,15:2007:False:False,False,False
Saints,7,14,10,0,0,31,Cardinals,7,7,7,3,0,24,15:2007:False:False,False,False
Raiders,0,7,0,7,0,14,Colts,10,0,3,8,0,21,15:2007:False:False,False,False
Cowboys,0,3,3,0,0,6,Eagles,0,7,0,3,0,10,15:2007:False:False,False,False
Chargers,17,17,10,7,0,51,Lions,0,7,7,0,0,14,15:2007:False:False,False,False
Giants,0,3,7,0,0,10,Redskins,3,13,6,0,0,22,15:2007:False:False,False,False
Vikings,0,6,6,8,0,20,Bears,3,10,0,0,0,13,15:2007:False:False,False,False
Rams,7,10,7,0,0,24,Steelers,7,17,7,10,0,41,16:2007:False:False,False,False
Panthers,0,7,3,3,0,13,Cowboys,7,10,0,3,0,20,16:2007:False:False,False,False
Saints,14,3,0,6,0,23,Eagles,21,3,7,7,0,38,16:2007:False:False,False,False
Bills,14,0,7,0,0,21,Giants,0,17,0,21,0,38,16:2007:False:False,False,False
Bears,3,10,15,7,0,35,Packers,0,7,0,0,0,7,16:2007:False:False,False,False
Bengals,0,19,0,0,0,19,Browns,0,0,7,7,0,14,16:2007:False:False,False,False
Lions,9,10,3,3,0,25,Chiefs,0,14,0,6,0,20,16:2007:False:False,False,False
Colts,3,21,14,0,0,38,Texans,7,0,0,8,0,15,16:2007:False:False,False,False
Jaguars,14,14,7,14,0,49,Raiders,0,3,0,8,0,11,16:2007:False:False,False,False
49ers,0,7,7,7,0,21,Buccaneers,6,7,0,6,0,19,16:2007:False:False,False,False
Cardinals,7,17,0,3,3,30,Falcons,7,7,0,13,0,27,16:2007:False:False,False,False
Seahawks,0,21,6,0,0,27,Ravens,0,0,0,6,0,6,16:2007:False:False,False,False
Titans,0,7,3,0,0,10,Jets,0,6,0,0,0,6,16:2007:False:False,False,False
Patriots,7,21,0,0,0,28,Dolphins,0,0,7,0,0,7,16:2007:False:False,False,False
Vikings,0,0,7,14,0,21,Redskins,9,13,3,7,0,32,16:2007:False:False,False,False
Chargers,10,6,7,0,0,23,Broncos,0,0,3,0,0,3,16:2007:False:False,False,False
Giants,7,14,7,7,0,35,Patriots,3,13,7,15,0,38,17:2007:False:False,False,False
Bears,10,14,7,2,0,33,Saints,0,17,0,8,0,25,17:2007:False:False,False,False
Packers,14,7,10,3,0,34,Lions,3,7,3,0,0,13,17:2007:False:False,False,False
Dolphins,3,7,0,15,0,25,Bengals,7,14,7,10,0,38,17:2007:False:False,False,False
Eagles,7,3,7,0,0,17,Bills,0,3,6,0,0,9,17:2007:False:False,False,False
Buccaneers,7,6,7,3,0,23,Panthers,7,10,7,7,0,31,17:2007:False:False,False,False
Texans,0,21,14,7,0,42,Jaguars,7,7,7,7,0,28,17:2007:False:False,False,False
Browns,7,10,0,3,0,20,49ers,0,7,0,0,0,7,17:2007:False:False,False,False
Falcons,0,17,3,24,0,44,Seahawks,7,10,10,14,0,41,17:2007:False:False,False,False
Ravens,10,10,7,0,0,27,Steelers,0,7,0,14,0,21,17:2007:False:False,False,False
Redskins,7,6,7,7,0,27,Cowboys,0,3,0,3,0,6,17:2007:False:False,False,False
Raiders,7,3,7,0,0,17,Chargers,7,7,10,6,0,30,17:2007:False:False,False,False
Jets,0,10,0,0,3,13,Chiefs,0,3,0,7,0,10,17:2007:False:False,False,False
Cardinals,3,21,7,17,0,48,Rams,3,3,13,0,0,19,17:2007:False:False,False,False
Broncos,0,14,3,2,3,22,Vikings,0,3,0,16,0,19,17:2007:False:False,False,False
Colts,0,3,7,0,0,10,Titans,7,0,3,6,0,16,17:2007:False:False,False,False
Seahawks,7,3,3,22,0,35,Redskins,0,0,0,14,0,14,18:2007:False:True,False,True
Steelers,7,0,3,19,0,29,Jaguars,7,14,7,3,0,31,18:2007:False:True,False,True
Buccaneers,7,0,0,7,0,14,Giants,0,14,3,7,0,24,18:2007:False:True,False,True
Chargers,0,0,10,7,0,17,Titans,3,3,0,0,0,6,18:2007:False:True,False,True
Packers,14,14,7,7,0,42,Seahawks,14,3,3,0,0,20,19:2007:False:True,False,True
Patriots,7,7,14,3,0,31,Jaguars,7,7,3,3,0,20,19:2007:False:True,False,True
Colts,7,3,7,7,0,24,Chargers,0,7,14,7,0,28,19:2007:False:True,False,True
Cowboys,0,14,3,0,0,17,Giants,7,7,0,7,0,21,19:2007:False:True,False,True
Patriots,0,14,0,7,0,21,Chargers,3,6,3,0,0,12,20:2007:False:True,False,True
Packers,0,10,7,3,0,20,Giants,3,3,14,0,3,23,20:2007:False:True,False,True
Patriots,0,7,0,7,0,14,Giants,3,0,0,14,0,17,21:2007:False:True,False,True
Lions,7,3,0,3,0,13,Giants,0,3,0,7,0,10,1:2008:True:False,True,False
Browns,7,7,3,3,0,20,Jets,0,10,0,14,0,24,1:2008:True:False,True,False
Patriots,0,3,3,9,0,15,Ravens,3,10,3,0,0,16,1:2008:True:False,True,False
Bears,0,3,14,3,0,20,Chiefs,7,7,0,10,0,24,1:2008:True:False,True,False
Cardinals,0,10,0,0,0,10,Saints,7,0,10,7,0,24,1:2008:True:False,True,False
Steelers,7,3,0,6,0,16,Eagles,3,7,0,0,0,10,1:2008:True:False,True,False
Vikings,7,10,0,0,0,17,Seahawks,17,0,14,3,0,34,1:2008:True:False,True,False
Raiders,0,7,8,3,0,18,49ers,0,3,0,3,0,6,1:2008:True:False,True,False
Redskins,7,7,3,0,0,17,Bills,3,11,0,0,0,14,1:2008:True:False,True,False
Panthers,14,6,0,0,3,23,Colts,3,14,3,0,0,20,1:2008:True:False,True,False
Jaguars,7,3,7,3,0,20,Falcons,0,7,10,0,0,17,1:2008:True:False,True,False
Dolphins,0,3,3,0,0,6,Buccaneers,0,7,0,10,0,17,1:2008:True:False,True,False
Titans,7,13,7,7,0,34,Rams,3,10,0,0,0,13,1:2008:True:False,True,False
Texans,3,10,3,3,0,19,Broncos,7,0,3,6,0,16,1:2008:True:False,True,False
Chargers,7,17,7,0,0,31,Cowboys,7,3,7,0,0,17,1:2008:True:False,True,False
Packers,10,0,0,7,0,17,Bengals,0,17,0,3,0,20,1:2008:True:False,True,False
Bills,7,7,10,0,0,24,Steelers,0,7,7,7,0,21,2:2008:True:False,True,False
Eagles,0,0,0,24,0,24,Panthers,7,3,0,3,0,13,2:2008:True:False,True,False
Titans,0,7,7,3,0,17,Raiders,0,10,0,6,0,16,2:2008:True:False,True,False
Jets,7,0,0,3,0,10,Redskins,0,3,3,7,0,13,2:2008:True:False,True,False
Ravens,7,0,0,8,0,15,Vikings,7,13,3,0,0,23,2:2008:True:False,True,False
Jaguars,0,0,0,14,0,14,Dolphins,7,6,3,3,0,19,2:2008:True:False,True,False
Falcons,6,0,3,0,0,9,Colts,0,10,3,3,0,16,2:2008:True:False,True,False
Saints,6,14,7,0,0,27,Texans,7,10,7,7,0,31,2:2008:True:False,True,False
Chiefs,3,3,3,8,0,17,Cardinals,0,6,14,7,0,27,2:2008:True:False,True,False
Rams,0,0,7,0,0,7,Chargers,6,0,0,0,0,6,2:2008:True:False,True,False
Seahawks,6,3,0,17,3,29,Bears,0,5,14,7,0,26,2:2008:True:False,True,False
Broncos,7,7,3,6,0,23,Cowboys,0,7,3,3,0,13,2:2008:True:False,True,False
49ers,0,14,10,10,0,34,Packers,3,0,3,0,0,6,2:2008:True:False,True,False
Bengals,0,7,3,0,0,10,Lions,7,0,3,17,0,27,2:2008:True:False,True,False
Buccaneers,7,10,10,0,0,27,Patriots,0,3,0,7,0,10,2:2008:True:False,True,False
Giants,23,7,7,0,0,37,Browns,3,14,7,10,0,34,2:2008:True:False,True,False
Bears,10,10,3,7,0,30,49ers,6,14,7,10,0,37,3:2008:True:False,True,False
Falcons,0,3,7,7,0,17,Titans,3,0,0,0,0,3,3:2008:True:False,True,False
Patriots,0,3,0,14,0,17,Eagles,3,21,3,0,0,27,3:2008:True:False,True,False
Cowboys,10,10,0,3,0,23,Texans,3,7,3,9,0,22,3:2008:True:False,True,False
Broncos,3,14,0,7,0,24,Packers,7,6,7,7,0,27,3:2008:True:False,True,False
Lions,6,10,10,0,0,26,Browns,0,6,0,0,0,6,3:2008:True:False,True,False
Jets,0,0,3,7,0,10,Giants,0,0,0,7,0,7,3:2008:True:False,True,False
Buccaneers,0,7,3,7,0,17,Jaguars,10,0,7,6,0,23,3:2008:True:False,True,False
Panthers,3,31,7,6,0,47,Redskins,0,0,3,0,0,3,3:2008:True:False,True,False
Dolphins,3,14,0,7,0,24,Chiefs,0,0,0,0,0,0,3:2008:True:False,True,False
Bengals,0,0,0,0,0,0,Saints,10,0,3,0,0,13,3:2008:True:False,True,False
Rams,3,14,7,0,0,24,Ravens,3,0,7,0,0,10,3:2008:True:False,True,False
Vikings,0,7,3,0,0,10,Steelers,0,3,3,6,0,12,3:2008:True:False,True,False
Raiders,0,0,0,0,0,0,Cardinals,3,0,14,7,0,24,3:2008:True:False,True,False
Colts,0,0,7,0,0,7,Bills,3,14,0,3,0,20,3:2008:True:False,True,False
Chargers,0,10,0,8,0,18,Seahawks,7,0,3,7,0,17,3:2008:True:False,True,False
Eagles,10,3,0,7,0,20,Jets,0,10,7,10,0,27,4:2008:True:False,True,False
Bills,3,0,0,3,0,6,Lions,5,9,0,0,0,14,4:2008:True:False,True,False
Giants,7,6,3,3,0,19,Patriots,0,0,0,14,0,14,4:2008:True:False,True,False
Packers,7,0,8,6,0,21,Titans,3,13,7,0,0,23,4:2008:True:False,True,False
Ravens,0,6,3,0,0,9,Falcons,0,7,3,0,0,10,4:2008:True:False,True,False
Redskins,0,3,0,0,0,3,Jaguars,7,10,0,7,0,24,4:2008:True:False,True,False
Colts,0,7,0,0,0,7,Bengals,7,10,3,7,0,27,4:2008:True:False,True,False
Steelers,10,3,3,3,0,19,Panthers,3,3,0,10,0,16,4:2008:True:False,True,False
Chiefs,14,7,0,0,0,21,Rams,3,7,0,7,0,17,4:2008:True:False,True,False
Browns,10,0,0,0,0,10,Bears,0,10,3,3,0,16,4:2008:True:False,True,False
Texans,3,3,0,0,0,6,Buccaneers,0,7,0,9,0,16,4:2008:True:False,True,False
Saints,3,7,0,0,0,10,Dolphins,0,14,0,0,0,14,4:2008:True:False,True,False
Cowboys,10,3,0,3,0,16,Vikings,0,7,3,0,0,10,4:2008:True:False,True,False
Cardinals,0,14,0,0,0,14,Broncos,3,7,0,18,0,28,4:2008:True:False,True,False
49ers,3,7,7,0,0,17,Chargers,7,6,0,7,0,20,4:2008:True:False,True,False
Seahawks,10,3,3,7,0,23,Raiders,0,6,3,7,0,16,4:2008:True:False,True,False
Giants,10,6,0,0,0,16,Redskins,0,7,0,0,0,7,1:2008:False:False,False,False
Dolphins,0,7,0,7,0,14,Jets,7,6,7,0,0,20,1:2008:False:False,False,False
Patriots,0,7,7,3,0,17,Chiefs,0,3,0,7,0,10,1:2008:False:False,False,False
Saints,7,0,10,7,0,24,Buccaneers,7,3,3,7,0,20,1:2008:False:False,False,False
Eagles,14,7,10,7,0,38,Rams,0,0,0,3,0,3,1:2008:False:False,False,False
Steelers,7,14,14,3,0,38,Texans,0,3,0,14,0,17,1:2008:False:False,False,False
Titans,3,7,0,7,0,17,Jaguars,0,7,0,3,0,10,1:2008:False:False,False,False
Bills,7,13,14,0,0,34,Seahawks,0,7,3,0,0,10,1:2008:False:False,False,False
Ravens,7,3,7,0,0,17,Bengals,0,3,0,7,0,10,1:2008:False:False,False,False
Falcons,21,0,10,3,0,34,Lions,0,14,7,0,0,21,1:2008:False:False,False,False
49ers,7,3,0,3,0,13,Cardinals,3,7,10,3,0,23,1:2008:False:False,False,False
Browns,0,7,0,3,0,10,Cowboys,7,14,7,0,0,28,1:2008:False:False,False,False
Chargers,0,7,3,14,0,24,Panthers,0,9,7,10,0,26,1:2008:False:False,False,False
Colts,3,3,7,0,0,13,Bears,7,8,7,7,0,29,1:2008:False:False,False,False
Packers,0,10,7,7,0,24,Vikings,0,3,3,13,0,19,1:2008:False:False,False,False
Raiders,0,0,0,14,0,14,Broncos,7,10,10,14,0,41,1:2008:False:False,False,False
Lions,0,3,6,16,0,25,Packers,7,14,3,24,0,48,2:2008:False:False,False,False
Jaguars,0,3,10,3,0,16,Bills,7,3,0,10,0,20,2:2008:False:False,False,False
Chiefs,0,0,0,8,0,8,Raiders,6,0,7,10,0,23,2:2008:False:False,False,False
Vikings,6,3,6,0,0,15,Colts,0,0,7,11,0,18,2:2008:False:False,False,False
Rams,0,6,0,7,0,13,Giants,7,6,7,21,0,41,2:2008:False:False,False,False
Redskins,3,6,6,14,0,29,Saints,0,10,14,0,0,24,2:2008:False:False,False,False
Panthers,0,3,10,7,0,20,Bears,7,3,7,0,0,17,2:2008:False:False,False,False
Bengals,0,7,0,0,0,7,Titans,0,14,3,7,0,24,2:2008:False:False,False,False
Buccaneers,7,10,0,7,0,24,Falcons,0,3,3,3,0,9,2:2008:False:False,False,False
Seahawks,14,6,0,10,0,30,49ers,3,10,14,3,3,33,2:2008:False:False,False,False
Cardinals,14,3,14,0,0,31,Dolphins,0,0,3,7,0,10,2:2008:False:False,False,False
Broncos,7,24,0,8,0,39,Chargers,3,14,10,11,0,38,2:2008:False:False,False,False
Jets,0,3,0,7,0,10,Patriots,3,3,10,3,0,19,2:2008:False:False,False,False
Browns,0,0,3,3,0,6,Steelers,0,7,3,0,0,10,2:2008:False:False,False,False
Cowboys,14,10,7,10,0,41,Eagles,6,24,0,7,0,37,2:2008:False:False,False,False
Bears,6,3,8,7,0,24,Buccaneers,7,7,0,10,3,27,3:2008:False:False,False,False
Vikings,0,10,7,3,0,20,Panthers,3,7,0,0,0,10,3:2008:False:False,False,False
Patriots,0,6,7,0,0,13,Dolphins,7,14,7,10,0,38,3:2008:False:False,False,False
Giants,0,10,3,10,3,26,Bengals,3,10,0,10,0,23,3:2008:False:False,False,False
Titans,7,14,3,7,0,31,Texans,6,6,0,0,0,12,3:2008:False:False,False,False
Redskins,7,3,7,7,0,24,Cardinals,0,7,10,0,0,17,3:2008:False:False,False,False
Falcons,14,10,7,7,0,38,Chiefs,0,7,7,0,0,14,3:2008:False:False,False,False
Bills,0,7,0,17,0,24,Raiders,6,3,7,7,0,23,3:2008:False:False,False,False
49ers,7,14,0,10,0,31,Lions,0,3,3,7,0,13,3:2008:False:False,False,False
Seahawks,17,10,0,10,0,37,Rams,0,6,7,0,0,13,3:2008:False:False,False,False
Broncos,14,10,10,0,0,34,Saints,3,16,7,6,0,32,3:2008:False:False,False,False
Ravens,0,7,21,0,0,28,Browns,0,10,0,0,0,10,3:2008:False:False,False,False
Colts,7,7,0,7,0,21,Jaguars,0,10,7,6,0,23,3:2008:False:False,False,False
Eagles,0,10,0,5,0,15,Steelers,3,3,0,0,0,6,3:2008:False:False,False,False
Packers,3,3,3,7,0,16,Cowboys,3,10,7,7,0,27,3:2008:False:False,False,False
Chargers,10,21,7,10,0,48,Jets,7,7,0,15,0,29,3:2008:False:False,False,False
Bengals,0,6,0,6,0,12,Browns,3,0,0,17,0,20,4:2008:False:False,False,False
Jaguars,7,3,7,10,3,30,Texans,3,7,7,10,0,27,4:2008:False:False,False,False
Chiefs,6,7,3,17,0,33,Broncos,0,10,3,6,0,19,4:2008:False:False,False,False
Saints,0,21,0,10,0,31,49ers,3,3,3,8,0,17,4:2008:False:False,False,False
Jets,0,34,0,22,0,56,Cardinals,0,0,21,14,0,35,4:2008:False:False,False,False
Titans,10,10,3,7,0,30,Vikings,0,10,0,7,0,17,4:2008:False:False,False,False
Panthers,7,7,3,7,0,24,Falcons,3,6,0,0,0,9,4:2008:False:False,False,False
Buccaneers,0,13,7,10,0,30,Packers,7,0,7,7,0,21,4:2008:False:False,False,False
Rams,7,7,0,0,0,14,Bills,6,0,7,18,0,31,4:2008:False:False,False,False
Raiders,5,10,0,3,0,18,Chargers,0,0,3,25,0,28,4:2008:False:False,False,False
Cowboys,7,3,7,7,0,24,Redskins,0,17,3,6,0,26,4:2008:False:False,False,False
Bears,7,14,0,3,0,24,Eagles,7,7,3,3,0,20,4:2008:False:False,False,False
Steelers,3,0,14,3,3,23,Ravens,3,10,0,7,0,20,4:2008:False:False,False,False
Panthers,7,14,10,3,0,34,Chiefs,0,0,0,0,0,0,5:2008:False:False,False,False
Lions,0,0,7,0,0,7,Bears,3,14,14,3,0,34,5:2008:False:False,False,False
Packers,0,7,3,14,0,24,Falcons,10,7,0,10,0,27,5:2008:False:False,False,False
Texans,0,17,3,7,0,27,Colts,10,0,0,21,0,31,5:2008:False:False,False,False
Dolphins,3,14,0,0,0,17,Chargers,3,0,7,0,0,10,5:2008:False:False,False,False
Eagles,14,0,0,3,0,17,Redskins,0,9,7,7,0,23,5:2008:False:False,False,False
Ravens,3,0,7,0,0,10,Titans,0,3,0,10,0,13,5:2008:False:False,False,False
Giants,14,13,10,7,0,44,Seahawks,3,3,0,0,0,6,5:2008:False:False,False,False
Broncos,0,6,7,3,0,16,Buccaneers,3,3,0,7,0,13,5:2008:False:False,False,False
Cardinals,7,17,7,10,0,41,Bills,0,14,3,0,0,17,5:2008:False:False,False,False
Cowboys,10,7,0,14,0,31,Bengals,0,6,7,9,0,22,5:2008:False:False,False,False
49ers,14,0,0,7,0,21,Patriots,7,10,7,6,0,30,5:2008:False:False,False,False
Jaguars,14,0,0,7,0,21,Steelers,7,13,0,6,0,26,5:2008:False:False,False,False
Saints,10,0,7,10,0,27,Vikings,10,10,0,10,0,30,5:2008:False:False,False,False
Vikings,2,0,7,3,0,12,Lions,0,3,7,0,0,10,6:2008:False:False,False,False
Redskins,7,0,0,10,0,17,Rams,3,7,6,3,0,19,6:2008:False:False,False,False
Buccaneers,14,3,3,7,0,27,Panthers,0,3,0,0,0,3,6:2008:False:False,False,False
Jets,7,10,3,6,0,26,Bengals,7,7,0,0,0,14,6:2008:False:False,False,False
Saints,0,10,14,10,0,34,Raiders,3,0,0,0,0,3,6:2008:False:False,False,False
Falcons,6,3,3,10,0,22,Bears,0,3,7,10,0,20,6:2008:False:False,False,False
Texans,3,10,7,9,0,29,Dolphins,7,7,7,7,0,28,6:2008:False:False,False,False
Colts,17,7,7,0,0,31,Ravens,0,0,3,0,0,3,6:2008:False:False,False,False
Broncos,7,0,3,7,0,17,Jaguars,3,7,14,0,0,24,6:2008:False:False,False,False
Cardinals,7,0,7,10,6,30,Cowboys,0,7,7,10,0,24,6:2008:False:False,False,False
49ers,6,10,10,0,0,26,Eagles,7,10,0,23,0,40,6:2008:False:False,False,False
Seahawks,0,10,0,7,0,17,Packers,3,7,7,10,0,27,6:2008:False:False,False,False
Chargers,10,7,10,3,0,30,Patriots,0,3,0,7,0,10,6:2008:False:False,False,False
Browns,3,14,3,15,0,35,Giants,0,14,0,0,0,14,6:2008:False:False,False,False
Panthers,3,10,14,3,0,30,Saints,0,7,0,0,0,7,7:2008:False:False,False,False
Bears,14,13,14,7,0,48,Vikings,14,10,7,10,0,41,7:2008:False:False,False,False
Bengals,0,7,3,0,0,10,Steelers,10,0,7,21,0,38,7:2008:False:False,False,False
Chiefs,0,0,0,10,0,10,Titans,10,7,3,14,0,34,7:2008:False:False,False,False
Dolphins,3,3,7,0,0,13,Ravens,3,14,3,7,0,27,7:2008:False:False,False,False
Rams,21,3,7,3,0,34,Cowboys,7,0,0,7,0,14,7:2008:False:False,False,False
Bills,3,10,7,3,0,23,Chargers,7,0,7,0,0,14,7:2008:False:False,False,False
Giants,7,10,7,5,0,29,49ers,3,7,7,0,0,17,7:2008:False:False,False,False
Texans,14,7,7,0,0,28,Lions,0,3,7,11,0,21,7:2008:False:False,False,False
Packers,3,14,10,7,0,34,Colts,7,0,0,7,0,14,7:2008:False:False,False,False
Raiders,3,0,7,3,3,16,Jets,3,0,0,10,0,13,7:2008:False:False,False,False
Redskins,0,0,7,7,0,14,Browns,0,0,3,8,0,11,7:2008:False:False,False,False
Buccaneers,7,10,0,3,0,20,Seahawks,0,0,3,7,0,10,7:2008:False:False,False,False
Patriots,6,14,14,7,0,41,Broncos,0,0,0,7,0,7,7:2008:False:False,False,False
Eagles,0,10,7,10,0,27,Falcons,0,7,0,7,0,14,8:2008:False:False,False,False
Ravens,2,17,3,7,0,29,Raiders,0,0,10,0,0,10,8:2008:False:False,False,False
Saints,3,20,7,7,0,37,Chargers,3,14,3,12,0,32,8:2008:False:False,False,False
Patriots,7,6,0,10,0,23,Rams,3,7,3,3,0,16,8:2008:False:False,False,False
Dolphins,7,0,10,8,0,25,Bills,3,6,7,0,0,16,8:2008:False:False,False,False
Jets,7,7,7,7,0,28,Chiefs,0,14,3,7,0,24,8:2008:False:False,False,False
Panthers,0,3,21,3,0,27,Cardinals,3,7,13,0,0,23,8:2008:False:False,False,False
Cowboys,0,10,3,0,0,13,Buccaneers,6,0,3,0,0,9,8:2008:False:False,False,False
Lions,7,3,0,7,0,17,Redskins,3,3,10,9,0,25,8:2008:False:False,False,False
Jaguars,0,7,7,3,0,17,Browns,7,10,0,6,0,23,8:2008:False:False,False,False
Texans,7,7,14,7,0,35,Bengals,3,3,0,0,0,6,8:2008:False:False,False,False
49ers,0,3,3,7,0,13,Seahawks,6,14,7,7,0,34,8:2008:False:False,False,False
Steelers,7,0,7,0,0,14,Giants,3,6,0,12,0,21,8:2008:False:False,False,False
Titans,3,3,8,17,0,31,Colts,7,0,7,7,0,21,8:2008:False:False,False,False
Bears,10,3,7,7,0,27,Lions,0,23,0,0,0,23,9:2008:False:False,False,False
Bengals,7,7,7,0,0,21,Jaguars,0,3,0,16,0,19,9:2008:False:False,False,False
Browns,7,6,14,0,0,27,Ravens,10,3,7,17,0,37,9:2008:False:False,False,False
Chiefs,14,10,0,3,0,27,Buccaneers,0,13,0,14,3,30,9:2008:False:False,False,False
Vikings,7,14,0,7,0,28,Texans,7,0,7,7,0,21,9:2008:False:False,False,False
Titans,3,10,3,0,3,19,Packers,0,10,3,3,0,16,9:2008:False:False,False,False
Bills,7,0,3,7,0,17,Jets,13,0,10,3,0,26,9:2008:False:False,False,False
Rams,7,0,0,6,0,13,Cardinals,0,24,7,3,0,34,9:2008:False:False,False,False
Broncos,7,0,3,7,0,17,Dolphins,13,3,0,10,0,26,9:2008:False:False,False,False
Giants,14,7,7,7,0,35,Cowboys,0,7,0,7,0,14,9:2008:False:False,False,False
Raiders,0,0,0,0,0,0,Falcons,14,10,0,0,0,24,9:2008:False:False,False,False
Seahawks,7,0,0,0,0,7,Eagles,0,14,6,6,0,26,9:2008:False:False,False,False
Colts,7,0,8,3,0,18,Patriots,0,6,6,3,0,15,9:2008:False:False,False,False
Redskins,6,0,0,0,0,6,Steelers,0,10,6,7,0,23,9:2008:False:False,False,False
Browns,7,13,3,7,0,30,Broncos,7,3,3,21,0,34,10:2008:False:False,False,False
Lions,7,0,0,7,0,14,Jaguars,3,21,7,7,0,38,10:2008:False:False,False,False
Jets,17,23,0,7,0,47,Rams,0,0,3,0,0,3,10:2008:False:False,False,False
Patriots,7,3,3,7,0,20,Bills,0,3,0,7,0,10,10:2008:False:False,False,False
Vikings,7,7,7,7,0,28,Packers,7,3,14,3,0,27,10:2008:False:False,False,False
Dolphins,7,7,0,7,0,21,Seahawks,0,7,6,6,0,19,10:2008:False:False,False,False
Falcons,7,10,3,14,0,34,Saints,3,3,0,14,0,20,10:2008:False:False,False,False
Bears,7,0,0,7,0,14,Titans,0,7,7,7,0,21,10:2008:False:False,False,False
Texans,0,6,7,0,0,13,Ravens,7,5,7,22,0,41,10:2008:False:False,False,False
Raiders,0,0,6,0,0,6,Panthers,7,7,0,3,0,17,10:2008:False:False,False,False
Steelers,7,10,0,3,0,20,Colts,7,7,3,7,0,24,10:2008:False:False,False,False
Chargers,0,6,7,7,0,20,Chiefs,7,6,0,6,0,19,10:2008:False:False,False,False
Eagles,7,10,7,7,0,31,Giants,10,10,7,9,0,36,10:2008:False:False,False,False
Cardinals,3,10,7,9,0,29,49ers,7,14,3,0,0,24,10:2008:False:False,False,False
Patriots,3,10,8,10,0,31,Jets,10,14,0,7,3,34,11:2008:False:False,False,False
Colts,3,6,14,10,0,33,Texans,6,7,7,7,0,27,11:2008:False:False,False,False
Buccaneers,3,3,7,6,0,19,Vikings,3,10,0,0,0,13,11:2008:False:False,False,False
Giants,13,7,7,3,0,30,Ravens,0,3,7,0,0,10,11:2008:False:False,False,False
Dolphins,7,0,7,3,0,17,Raiders,0,3,2,10,0,15,11:2008:False:False,False,False
Chiefs,7,3,3,7,0,20,Saints,3,10,14,3,0,30,11:2008:False:False,False,False
Packers,7,10,7,13,0,37,Bears,0,3,0,0,0,3,11:2008:False:False,False,False
Falcons,3,10,0,7,0,20,Broncos,7,0,7,10,0,24,11:2008:False:False,False,False
Panthers,0,21,3,7,0,31,Lions,7,9,0,6,0,22,11:2008:False:False,False,False
Bengals,0,10,3,0,0,13,Eagles,0,3,7,3,0,13,11:2008:False:False,False,False
Seahawks,0,7,0,13,0,20,Cardinals,10,6,10,0,0,26,11:2008:False:False,False,False
49ers,7,28,0,0,0,35,Rams,0,3,6,7,0,16,11:2008:False:False,False,False
Jaguars,0,14,0,0,0,14,Titans,3,0,14,7,0,24,11:2008:False:False,False,False
Steelers,0,5,3,3,0,11,Chargers,7,0,0,3,0,10,11:2008:False:False,False,False
Redskins,7,3,0,0,0,10,Cowboys,0,7,0,7,0,14,11:2008:False:False,False,False
Bills,0,10,3,14,0,27,Browns,6,7,3,13,0,29,11:2008:False:False,False,False
Steelers,0,10,10,7,0,27,Bengals,7,0,0,3,0,10,12:2008:False:False,False,False
Lions,17,0,3,0,0,20,Buccaneers,0,21,14,3,0,38,12:2008:False:False,False,False
Ravens,0,10,2,24,0,36,Eagles,0,7,0,0,0,7,12:2008:False:False,False,False
Browns,0,6,0,0,0,6,Texans,7,6,3,0,0,16,12:2008:False:False,False,False
Cowboys,0,22,7,6,0,35,49ers,6,0,3,13,0,22,12:2008:False:False,False,False
Titans,0,3,0,10,0,13,Jets,7,3,10,14,0,34,12:2008:False:False,False,False
Jaguars,7,3,0,2,0,12,Vikings,17,0,3,10,0,30,12:2008:False:False,False,False
Chiefs,7,10,7,7,0,31,Bills,7,23,17,7,0,54,12:2008:False:False,False,False
Dolphins,7,7,7,7,0,28,Patriots,3,14,14,17,0,48,12:2008:False:False,False,False
Rams,0,3,0,0,0,3,Bears,14,10,3,0,0,27,12:2008:False:False,False,False
Broncos,0,3,7,0,0,10,Raiders,0,10,7,14,0,31,12:2008:False:False,False,False
Falcons,10,7,0,28,0,45,Panthers,0,3,10,15,0,28,12:2008:False:False,False,False
Seahawks,3,7,0,7,0,17,Redskins,0,7,10,3,0,20,12:2008:False:False,False,False
Cardinals,3,9,7,10,0,29,Giants,0,17,7,13,0,37,12:2008:False:False,False,False
Chargers,0,10,0,10,0,20,Colts,3,7,7,6,0,23,12:2008:False:False,False,False
Saints,14,10,21,6,0,51,Packers,7,14,0,8,0,29,12:2008:False:False,False,False
Lions,3,7,0,0,0,10,Titans,21,14,6,6,0,47,13:2008:False:False,False,False
Cowboys,14,10,7,3,0,34,Seahawks,3,3,3,0,0,9,13:2008:False:False,False,False
Eagles,14,10,10,14,0,48,Cardinals,0,7,6,7,0,20,13:2008:False:False,False,False
Browns,3,3,0,0,0,6,Colts,3,0,0,7,0,10,13:2008:False:False,False,False
Redskins,0,7,0,0,0,7,Giants,10,3,7,3,0,23,13:2008:False:False,False,False
Buccaneers,0,6,14,3,0,23,Saints,3,7,0,10,0,20,13:2008:False:False,False,False
Rams,6,3,0,3,0,12,Dolphins,0,10,3,3,0,16,13:2008:False:False,False,False
Bills,0,0,3,0,0,3,49ers,7,3,0,0,0,10,13:2008:False:False,False,False
Bengals,0,3,0,0,0,3,Ravens,3,10,14,7,0,34,13:2008:False:False,False,False
Packers,0,10,11,10,0,31,Panthers,7,14,0,14,0,35,13:2008:False:False,False,False
Chargers,7,0,6,3,0,16,Falcons,6,9,0,7,0,22,13:2008:False:False,False,False
Jets,7,7,3,0,0,17,Broncos,17,10,0,7,0,34,13:2008:False:False,False,False
Patriots,7,3,0,0,0,10,Steelers,3,7,13,10,0,33,13:2008:False:False,False,False
Raiders,3,0,7,3,0,13,Chiefs,3,7,0,10,0,20,13:2008:False:False,False,False
Vikings,0,17,7,10,0,34,Bears,7,0,7,0,0,14,13:2008:False:False,False,False
Texans,10,0,6,14,0,30,Jaguars,0,0,3,14,0,17,13:2008:False:False,False,False
Chargers,10,17,0,7,0,34,Raiders,0,7,0,0,0,7,14:2008:False:False,False,False
Titans,0,14,7,7,0,28,Browns,6,0,0,3,0,9,14:2008:False:False,False,False
Bears,10,10,0,3,0,23,Jaguars,3,0,0,7,0,10,14:2008:False:False,False,False
Lions,3,3,7,3,0,16,Vikings,0,3,7,10,0,20,14:2008:False:False,False,False
Packers,0,7,0,14,0,21,Texans,7,3,3,11,0,24,14:2008:False:False,False,False
Colts,7,7,14,7,0,35,Bengals,0,3,0,0,0,3,14:2008:False:False,False,False
Saints,7,9,0,13,0,29,Falcons,0,14,3,8,0,25,14:2008:False:False,False,False
Giants,0,7,0,7,0,14,Eagles,3,7,0,10,0,20,14:2008:False:False,False,False
Seahawks,7,7,7,0,0,21,Patriots,3,7,3,11,0,24,14:2008:False:False,False,False
49ers,7,7,0,10,0,24,Jets,0,7,7,0,0,14,14:2008:False:False,False,False
Broncos,7,7,3,7,0,24,Chiefs,10,7,0,0,0,17,14:2008:False:False,False,False
Bills,3,0,0,0,0,3,Dolphins,7,6,0,3,0,16,14:2008:False:False,False,False
Steelers,0,3,0,17,0,20,Cowboys,0,3,10,0,0,13,14:2008:False:False,False,False
Cardinals,14,6,7,7,0,34,Rams,0,7,0,3,0,10,14:2008:False:False,False,False
Ravens,14,0,3,7,0,24,Redskins,0,0,0,10,0,10,14:2008:False:False,False,False
Panthers,3,7,7,21,0,38,Buccaneers,0,3,14,6,0,23,14:2008:False:False,False,False
Bears,7,14,0,3,3,27,Saints,0,7,7,10,0,24,15:2008:False:False,False,False
Falcons,10,0,0,0,3,13,Buccaneers,0,7,0,3,0,10,15:2008:False:False,False,False
Rams,7,10,0,3,0,20,Seahawks,7,0,6,10,0,23,15:2008:False:False,False,False
Jets,14,7,0,10,0,31,Bills,3,14,3,7,0,27,15:2008:False:False,False,False
Dolphins,7,7,0,0,0,14,49ers,3,0,3,3,0,9,15:2008:False:False,False,False
Chiefs,7,7,7,0,0,21,Chargers,0,3,7,12,0,22,15:2008:False:False,False,False
Jaguars,7,0,0,13,0,20,Packers,3,10,0,3,0,16,15:2008:False:False,False,False
Bengals,14,3,0,3,0,20,Redskins,0,10,0,3,0,13,15:2008:False:False,False,False
Texans,0,10,0,3,0,13,Titans,3,3,3,3,0,12,15:2008:False:False,False,False
Colts,7,14,0,10,0,31,Lions,3,7,3,8,0,21,15:2008:False:False,False,False
Cardinals,0,0,14,0,0,14,Vikings,21,7,7,0,0,35,15:2008:False:False,False,False
Raiders,7,7,6,6,0,26,Patriots,21,14,7,7,0,49,15:2008:False:False,False,False
Panthers,10,10,7,3,0,30,Broncos,10,0,0,0,0,10,15:2008:False:False,False,False
Ravens,0,6,3,0,0,9,Steelers,0,3,0,10,0,13,15:2008:False:False,False,False
Cowboys,0,7,0,13,0,20,Giants,0,3,0,5,0,8,15:2008:False:False,False,False
Eagles,10,7,3,10,0,30,Browns,3,0,0,7,0,10,15:2008:False:False,False,False
Jaguars,7,10,7,0,0,24,Colts,0,7,7,17,0,31,16:2008:False:False,False,False
Cowboys,7,0,0,17,0,24,Ravens,3,6,7,17,0,33,16:2008:False:False,False,False
Browns,0,0,0,0,0,0,Bengals,7,7,0,0,0,14,16:2008:False:False,False,False
Lions,0,7,0,0,0,7,Saints,14,14,14,0,0,42,16:2008:False:False,False,False
Chiefs,7,21,3,0,0,31,Dolphins,10,14,7,7,0,38,16:2008:False:False,False,False
Buccaneers,7,3,14,0,0,24,Chargers,7,13,0,21,0,41,16:2008:False:False,False,False
Patriots,14,17,13,3,0,47,Cardinals,0,0,0,7,0,7,16:2008:False:False,False,False
Titans,0,10,7,14,0,31,Steelers,0,7,7,0,0,14,16:2008:False:False,False,False
Rams,0,13,0,3,0,16,49ers,3,0,0,14,0,17,16:2008:False:False,False,False
Broncos,10,3,7,3,0,23,Bills,0,10,6,14,0,30,16:2008:False:False,False,False
Seahawks,0,7,3,3,0,13,Jets,3,0,0,0,0,3,16:2008:False:False,False,False
Raiders,13,0,14,0,0,27,Texans,7,6,0,3,0,16,16:2008:False:False,False,False
Redskins,0,3,7,0,0,10,Eagles,0,0,3,0,0,3,16:2008:False:False,False,False
Vikings,7,0,0,10,0,17,Falcons,7,10,7,0,0,24,16:2008:False:False,False,False
Giants,3,10,7,8,6,34,Panthers,7,14,0,7,0,28,16:2008:False:False,False,False
Bears,0,3,7,7,3,20,Packers,0,14,0,3,0,17,16:2008:False:False,False,False
Bengals,3,10,0,3,0,16,Chiefs,0,0,0,6,0,6,17:2008:False:False,False,False
Buccaneers,0,7,7,10,0,24,Raiders,0,14,0,17,0,31,17:2008:False:False,False,False
Steelers,0,14,3,14,0,31,Browns,0,0,0,0,0,0,17:2008:False:False,False,False
Bills,0,0,0,0,0,0,Patriots,3,0,7,3,0,13,17:2008:False:False,False,False
Falcons,3,14,7,7,0,31,Rams,7,7,3,10,0,27,17:2008:False:False,False,False
Texans,0,14,7,10,0,31,Bears,10,0,7,7,0,24,17:2008:False:False,False,False
Colts,10,6,0,7,0,23,Titans,0,0,0,0,0,0,17:2008:False:False,False,False
Vikings,0,10,0,10,0,20,Giants,0,9,7,3,0,19,17:2008:False:False,False,False
Saints,0,10,0,21,0,31,Panthers,6,17,7,3,0,33,17:2008:False:False,False,False
Packers,14,0,0,17,0,31,Lions,0,7,7,7,0,21,17:2008:False:False,False,False
Cardinals,0,14,14,6,0,34,Seahawks,7,7,0,7,0,21,17:2008:False:False,False,False
Eagles,3,24,17,0,0,44,Cowboys,3,0,0,3,0,6,17:2008:False:False,False,False
Jets,0,9,8,0,0,17,Dolphins,0,14,7,3,0,24,17:2008:False:False,False,False
49ers,7,0,7,13,0,27,Redskins,0,17,0,7,0,24,17:2008:False:False,False,False
Ravens,3,21,3,0,0,27,Jaguars,7,0,0,0,0,7,17:2008:False:False,False,False
Chargers,10,14,14,14,0,52,Broncos,6,0,7,8,0,21,17:2008:False:False,False,False
Cardinals,7,7,14,2,0,30,Falcons,0,17,0,7,0,24,18:2008:False:True,False,True
Chargers,0,14,0,3,6,23,Colts,7,3,7,0,0,17,18:2008:False:True,False,True
Dolphins,3,0,0,6,0,9,Ravens,3,10,7,7,0,27,18:2008:False:True,False,True
Vikings,0,14,0,0,0,14,Eagles,6,10,0,10,0,26,18:2008:False:True,False,True
Titans,7,0,0,3,0,10,Ravens,7,0,0,6,0,13,19:2008:False:True,False,True
Panthers,7,0,0,6,0,13,Cardinals,14,13,3,3,0,33,19:2008:False:True,False,True
Giants,3,5,3,0,0,11,Eagles,7,3,3,10,0,23,19:2008:False:True,False,True
Steelers,7,7,7,14,0,35,Chargers,7,3,0,14,0,24,19:2008:False:True,False,True
Cardinals,7,17,0,8,0,32,Eagles,3,3,13,6,0,25,20:2008:False:True,False,True
Steelers,6,7,3,7,0,23,Ravens,0,7,0,7,0,14,20:2008:False:True,False,True
Cardinals,0,7,0,16,0,23,Steelers,3,14,3,7,0,27,21:2008:False:True,False,True
Ravens,3,10,3,7,0,23,Redskins,0,0,0,0,0,0,1:2009:True:False,True,False
Eagles,3,3,16,3,0,25,Patriots,7,14,3,3,0,27,1:2009:True:False,True,False
Steelers,0,3,0,17,0,20,Cardinals,0,3,0,7,0,10,1:2009:True:False,True,False
Raiders,3,7,14,7,0,31,Cowboys,7,0,3,0,0,10,1:2009:True:False,True,False
Jets,3,7,3,7,0,20,Rams,3,6,7,7,0,23,1:2009:True:False,True,False
Colts,0,3,0,0,0,3,Vikings,7,6,0,0,0,13,1:2009:True:False,True,False
Saints,0,7,7,3,0,17,Bengals,0,7,0,0,0,7,1:2009:True:False,True,False
49ers,3,6,0,8,0,17,Broncos,0,0,7,9,0,16,1:2009:True:False,True,False
Lions,3,0,14,10,0,27,Falcons,7,3,13,3,0,26,1:2009:True:False,True,False
Bills,0,6,7,14,0,27,Bears,3,3,7,7,0,20,1:2009:True:False,True,False
Titans,3,3,14,7,0,27,Buccaneers,0,12,0,8,0,20,1:2009:True:False,True,False
Chiefs,0,3,0,7,0,10,Texans,7,6,3,0,0,16,1:2009:True:False,True,False
Packers,14,0,0,3,0,17,Browns,0,0,0,0,0,0,1:2009:True:False,True,False
Chargers,0,7,0,7,0,14,Seahawks,0,7,7,6,0,20,1:2009:True:False,True,False
Dolphins,3,3,6,0,0,12,Jaguars,0,6,3,0,0,9,1:2009:True:False,True,False
Giants,7,7,0,10,0,24,Panthers,0,2,7,8,0,17,1:2009:True:False,True,False
Patriots,3,3,0,0,0,6,Bengals,0,7,0,0,0,7,2:2009:True:False,True,False
Colts,14,3,3,3,0,23,Eagles,7,0,0,8,0,15,2:2009:True:False,True,False
Vikings,0,7,7,3,0,17,Chiefs,3,7,3,0,0,13,2:2009:True:False,True,False
Rams,0,3,7,3,0,13,Falcons,14,0,3,3,0,20,2:2009:True:False,True,False
Cowboys,7,7,0,16,0,30,Titans,3,7,0,0,0,10,2:2009:True:False,True,False
Jaguars,7,7,3,6,0,23,Buccaneers,3,14,7,0,0,24,2:2009:True:False,True,False
Redskins,3,0,7,7,0,17,Steelers,7,3,3,0,0,13,2:2009:True:False,True,False
Browns,20,0,7,0,0,27,Lions,0,3,7,0,0,10,2:2009:True:False,True,False
Dolphins,7,3,10,7,0,27,Panthers,7,7,0,3,0,17,2:2009:True:False,True,False
Bears,10,7,0,0,0,17,Giants,0,3,0,0,0,3,2:2009:True:False,True,False
Texans,7,0,7,0,0,14,Saints,7,10,7,14,0,38,2:2009:True:False,True,False
Packers,14,10,0,7,0,31,Bills,0,0,7,14,0,21,2:2009:True:False,True,False
49ers,0,3,0,18,0,21,Raiders,0,7,7,6,0,20,2:2009:True:False,True,False
Cardinals,3,0,3,0,0,6,Chargers,0,14,3,0,0,17,2:2009:True:False,True,False
Seahawks,7,7,13,0,0,27,Broncos,10,0,0,3,0,13,2:2009:True:False,True,False
Ravens,14,7,0,3,0,24,Jets,0,7,10,6,0,23,2:2009:True:False,True,False
Eagles,3,3,14,13,0,33,Jaguars,0,17,12,3,0,32,3:2009:True:False,True,False
Bengals,7,7,0,7,0,21,Rams,14,7,3,0,0,24,3:2009:True:False,True,False
Buccaneers,3,3,0,0,0,6,Dolphins,0,3,7,0,0,10,3:2009:True:False,True,False
Redskins,7,10,7,0,0,24,Patriots,7,10,7,3,0,27,3:2009:True:False,True,False
Cardinals,0,10,7,20,0,37,Packers,10,28,0,6,0,44,3:2009:True:False,True,False
Lions,0,10,0,8,0,18,Colts,7,0,7,3,0,17,3:2009:True:False,True,False
Raiders,0,0,0,7,0,7,Saints,14,17,7,7,0,45,3:2009:True:False,True,False
Browns,0,3,17,3,0,23,Titans,7,0,7,3,0,17,3:2009:True:False,True,False
Steelers,0,17,0,0,0,17,Bills,0,0,0,0,0,0,3:2009:True:False,True,False
Panthers,3,0,0,10,0,13,Ravens,0,14,3,0,0,17,3:2009:True:False,True,False
Falcons,7,6,0,14,0,27,Chargers,7,14,0,3,0,24,3:2009:True:False,True,False
Chiefs,7,0,0,3,0,10,Seahawks,0,7,7,0,0,14,3:2009:True:False,True,False
Cowboys,0,10,0,3,0,13,49ers,0,3,7,10,0,20,3:2009:True:False,True,False
Giants,10,3,0,12,0,25,Jets,7,10,3,7,0,27,3:2009:True:False,True,False
Broncos,3,0,7,7,0,17,Bears,3,14,0,10,0,27,3:2009:True:False,True,False
Texans,0,10,0,0,0,10,Vikings,7,10,0,0,0,17,3:2009:True:False,True,False
Bills,0,0,3,3,0,6,Lions,0,7,0,10,0,17,4:2009:True:False,True,False
Jets,7,10,14,7,0,38,Eagles,7,17,0,3,0,27,4:2009:True:False,True,False
Bengals,10,14,7,7,0,38,Colts,7,0,0,0,0,7,4:2009:True:False,True,False
Falcons,0,3,0,0,0,3,Ravens,7,0,0,13,0,20,4:2009:True:False,True,False
Patriots,0,14,10,14,0,38,Giants,21,3,0,3,0,27,4:2009:True:False,True,False
Jaguars,10,11,0,3,0,24,Redskins,0,0,3,14,0,17,4:2009:True:False,True,False
Saints,0,0,0,7,0,7,Dolphins,3,7,0,0,0,10,4:2009:True:False,True,False
Rams,0,7,7,3,0,17,Chiefs,3,6,0,0,0,9,4:2009:True:False,True,False
Titans,3,17,7,0,0,27,Packers,3,0,7,3,0,13,4:2009:True:False,True,False
Bears,3,3,14,6,0,26,Browns,7,6,7,3,0,23,4:2009:True:False,True,False
Panthers,0,0,7,3,0,10,Steelers,14,0,7,0,0,21,4:2009:True:False,True,False
Broncos,10,6,3,0,0,19,Cardinals,0,0,0,0,0,0,4:2009:True:False,True,False
Seahawks,7,10,14,0,0,31,Raiders,7,0,0,14,0,21,4:2009:True:False,True,False
Buccaneers,3,7,3,7,0,20,Texans,0,17,10,0,0,27,4:2009:True:False,True,False
Vikings,7,14,7,3,0,31,Cowboys,7,0,14,14,0,35,4:2009:True:False,True,False
Chargers,7,6,6,7,0,26,49ers,0,7,0,0,0,7,4:2009:True:False,True,False
Steelers,0,7,0,3,3,13,Titans,0,7,0,3,0,10,1:2009:False:False,False,False
Saints,14,14,10,7,0,45,Lions,3,7,17,0,0,27,1:2009:False:False,False,False
Buccaneers,0,7,0,14,0,21,Cowboys,6,7,7,14,0,34,1:2009:False:False,False,False
Browns,3,10,0,7,0,20,Vikings,3,7,14,10,0,34,1:2009:False:False,False,False
Texans,0,0,0,7,0,7,Jets,3,7,7,7,0,24,1:2009:False:False,False,False
Colts,0,7,7,0,0,14,Jaguars,0,6,0,6,0,12,1:2009:False:False,False,False
Bengals,0,0,0,7,0,7,Broncos,0,3,3,6,0,12,1:2009:False:False,False,False
Panthers,7,3,0,0,0,10,Eagles,3,28,7,0,0,38,1:2009:False:False,False,False
Ravens,10,0,7,21,0,38,Chiefs,0,7,7,10,0,24,1:2009:False:False,False,False
Falcons,0,10,6,3,0,19,Dolphins,0,0,0,7,0,7,1:2009:False:False,False,False
Cardinals,0,6,7,3,0,16,49ers,6,7,0,7,0,20,1:2009:False:False,False,False
Giants,3,14,0,6,0,23,Redskins,0,7,3,7,0,17,1:2009:False:False,False,False
Seahawks,0,14,14,0,0,28,Rams,0,0,0,0,0,0,1:2009:False:False,False,False
Packers,0,10,0,11,0,21,Bears,0,2,10,3,0,15,1:2009:False:False,False,False
Patriots,0,10,0,15,0,25,Bills,7,7,3,7,0,24,1:2009:False:False,False,False
Raiders,7,3,0,10,0,20,Chargers,0,10,0,14,0,24,1:2009:False:False,False,False
Packers,14,7,0,3,0,24,Bengals,7,14,7,3,0,31,2:2009:False:False,False,False
Jaguars,3,0,7,7,0,17,Cardinals,10,14,7,0,0,31,2:2009:False:False,False,False
Chiefs,3,0,0,7,0,10,Raiders,0,3,3,7,0,13,2:2009:False:False,False,False
Jets,0,3,10,3,0,16,Patriots,3,6,0,0,0,9,2:2009:False:False,False,False
Eagles,7,6,7,2,0,22,Saints,10,7,17,14,0,48,2:2009:False:False,False,False
Titans,14,10,7,0,0,31,Texans,7,17,7,3,0,34,2:2009:False:False,False,False
Redskins,3,3,3,0,0,9,Rams,0,7,0,0,0,7,2:2009:False:False,False,False
Falcons,7,14,0,7,0,28,Panthers,3,10,0,7,0,20,2:2009:False:False,False,False
Lions,3,7,0,3,0,13,Vikings,0,7,10,10,0,27,2:2009:False:False,False,False
49ers,10,3,7,3,0,23,Seahawks,0,10,0,0,0,10,2:2009:False:False,False,False
Bills,17,3,0,13,0,33,Buccaneers,0,14,0,6,0,20,2:2009:False:False,False,False
Bears,0,7,0,10,0,17,Steelers,7,0,7,0,0,14,2:2009:False:False,False,False
Broncos,7,3,3,14,0,27,Browns,6,0,0,0,0,6,2:2009:False:False,False,False
Chargers,10,6,7,3,0,26,Ravens,7,14,7,3,0,31,2:2009:False:False,False,False
Cowboys,7,10,7,7,0,31,Giants,10,10,0,13,0,33,2:2009:False:False,False,False
Dolphins,7,6,0,10,0,23,Colts,7,6,0,14,0,27,2:2009:False:False,False,False
Lions,7,6,0,6,0,19,Redskins,0,0,7,7,0,14,3:2009:False:False,False,False
Texans,7,14,3,0,0,24,Jaguars,3,14,7,7,0,31,3:2009:False:False,False,False
Vikings,7,6,7,7,0,27,49ers,0,14,3,7,0,24,3:2009:False:False,False,False
Jets,14,0,7,3,0,24,Titans,0,10,7,0,0,17,3:2009:False:False,False,False
Eagles,14,10,3,7,0,34,Chiefs,0,7,0,7,0,14,3:2009:False:False,False,False
Rams,0,14,3,0,0,17,Packers,9,14,0,13,0,36,3:2009:False:False,False,False
Buccaneers,0,0,0,0,0,0,Giants,7,7,3,7,0,24,3:2009:False:False,False,False
Ravens,10,10,7,7,0,34,Browns,0,0,0,3,0,3,3:2009:False:False,False,False
Patriots,3,10,3,10,0,26,Falcons,3,7,0,0,0,10,3:2009:False:False,False,False
Seahawks,10,3,0,6,0,19,Bears,0,7,10,8,0,25,3:2009:False:False,False,False
Bills,0,7,0,0,0,7,Saints,7,3,0,17,0,27,3:2009:False:False,False,False
Chargers,0,3,7,13,0,23,Dolphins,0,3,3,7,0,13,3:2009:False:False,False,False
Raiders,0,3,0,0,0,3,Broncos,10,3,7,3,0,23,3:2009:False:False,False,False
Bengals,0,3,6,14,0,23,Steelers,10,3,7,0,0,20,3:2009:False:False,False,False
Cardinals,3,0,7,0,0,10,Colts,0,21,7,3,0,31,3:2009:False:False,False,False
Cowboys,0,0,10,11,0,21,Panthers,0,7,0,0,0,7,3:2009:False:False,False,False
Browns,0,7,7,6,0,20,Bengals,7,7,0,6,3,23,4:2009:False:False,False,False
Texans,3,17,9,0,0,29,Raiders,3,3,0,0,0,6,4:2009:False:False,False,False
Colts,7,14,7,6,0,34,Seahawks,0,3,0,14,0,17,4:2009:False:False,False,False
Jaguars,10,17,3,7,0,37,Titans,0,3,6,8,0,17,4:2009:False:False,False,False
Chiefs,3,0,0,13,0,16,Giants,7,10,3,7,0,27,4:2009:False:False,False,False
Redskins,0,0,16,0,0,16,Buccaneers,7,3,0,3,0,13,4:2009:False:False,False,False
Bears,7,14,13,14,0,48,Lions,14,7,0,3,0,24,4:2009:False:False,False,False
Patriots,3,14,7,3,0,27,Ravens,7,0,7,7,0,21,4:2009:False:False,False,False
Saints,3,14,0,7,0,24,Jets,0,3,7,0,0,10,4:2009:False:False,False,False
Dolphins,0,17,14,7,0,38,Bills,0,3,0,7,0,10,4:2009:False:False,False,False
Broncos,0,7,0,10,0,17,Cowboys,10,0,0,0,0,10,4:2009:False:False,False,False
49ers,0,7,14,14,0,35,Rams,0,0,0,0,0,0,4:2009:False:False,False,False
Steelers,14,7,7,10,0,38,Chargers,0,0,7,21,0,28,4:2009:False:False,False,False
Vikings,7,14,7,2,0,30,Packers,7,7,0,9,0,23,4:2009:False:False,False,False
Ravens,0,7,0,7,0,14,Bengals,0,3,7,7,0,17,5:2009:False:False,False,False
Giants,14,17,10,3,0,44,Raiders,0,7,0,0,0,7,5:2009:False:False,False,False
Chiefs,0,10,3,7,0,20,Cowboys,0,3,7,10,6,26,5:2009:False:False,False,False
Lions,6,7,0,7,0,20,Steelers,7,14,7,0,0,28,5:2009:False:False,False,False
Panthers,0,2,7,11,0,20,Redskins,7,3,7,0,0,17,5:2009:False:False,False,False
Eagles,7,14,7,5,0,33,Buccaneers,0,7,0,7,0,14,5:2009:False:False,False,False
Rams,0,3,0,7,0,10,Vikings,14,3,7,14,0,38,5:2009:False:False,False,False
Bills,0,0,3,0,0,3,Browns,0,3,0,3,0,6,5:2009:False:False,False,False
49ers,7,3,0,0,0,10,Falcons,14,21,3,7,0,45,5:2009:False:False,False,False
Seahawks,3,17,14,7,0,41,Jaguars,0,0,0,0,0,0,5:2009:False:False,False,False
Broncos,0,7,3,7,3,20,Patriots,10,7,0,0,0,17,5:2009:False:False,False,False
Cardinals,7,14,0,7,0,28,Texans,0,0,7,14,0,21,5:2009:False:False,False,False
Titans,6,3,0,0,0,9,Colts,7,14,7,3,0,31,5:2009:False:False,False,False
Dolphins,10,0,0,21,0,31,Jets,7,6,0,14,0,27,5:2009:False:False,False,False
Packers,14,9,3,0,0,26,Lions,0,0,0,0,0,0,6:2009:False:False,False,False
Jaguars,6,0,0,14,3,23,Rams,7,3,0,10,0,20,6:2009:False:False,False,False
Vikings,14,0,6,13,0,33,Ravens,0,3,7,21,0,31,6:2009:False:False,False,False
Saints,14,20,7,7,0,48,Giants,3,14,0,10,0,27,6:2009:False:False,False,False
Steelers,0,17,7,3,0,27,Browns,0,7,7,0,0,14,6:2009:False:False,False,False
Redskins,0,0,6,0,0,6,Chiefs,0,3,3,8,0,14,6:2009:False:False,False,False
Bengals,0,17,0,0,0,17,Texans,7,7,14,0,0,28,6:2009:False:False,False,False
Buccaneers,7,0,7,7,0,21,Panthers,0,7,14,7,0,28,6:2009:False:False,False,False
Seahawks,0,3,0,0,0,3,Cardinals,14,3,7,3,0,27,6:2009:False:False,False,False
Raiders,7,3,0,3,0,13,Eagles,3,3,0,3,0,9,6:2009:False:False,False,False
Patriots,10,35,14,0,0,59,Titans,0,0,0,0,0,0,6:2009:False:False,False,False
Jets,3,10,0,0,0,13,Bills,3,0,10,0,3,16,6:2009:False:False,False,False
Falcons,0,14,0,7,0,21,Bears,0,7,0,7,0,14,6:2009:False:False,False,False
Chargers,10,10,3,0,0,23,Broncos,7,10,7,10,0,34,6:2009:False:False,False,False
Texans,7,14,0,3,0,24,49ers,0,0,7,14,0,21,7:2009:False:False,False,False
Chiefs,0,0,7,0,0,7,Chargers,14,6,7,10,0,37,7:2009:False:False,False,False
Steelers,3,7,3,14,0,27,Vikings,0,7,3,7,0,17,7:2009:False:False,False,False
Rams,3,0,3,0,0,6,Colts,14,7,7,14,0,42,7:2009:False:False,False,False
Browns,0,3,0,0,0,3,Packers,0,21,3,7,0,31,7:2009:False:False,False,False
Buccaneers,0,7,0,0,0,7,Patriots,14,7,7,7,0,35,7:2009:False:False,False,False
Panthers,0,2,0,7,0,9,Bills,7,0,0,13,0,20,7:2009:False:False,False,False
Raiders,0,0,0,0,0,0,Jets,14,10,7,7,0,38,7:2009:False:False,False,False
Cowboys,0,17,7,13,0,37,Falcons,7,0,7,7,0,21,7:2009:False:False,False,False
Dolphins,14,10,10,0,0,34,Saints,3,7,14,22,0,46,7:2009:False:False,False,False
Bengals,14,17,7,7,0,45,Bears,0,3,0,7,0,10,7:2009:False:False,False,False
Giants,0,14,0,3,0,17,Cardinals,0,10,14,0,0,24,7:2009:False:False,False,False
Redskins,0,10,0,7,0,17,Eagles,14,13,0,0,0,27,7:2009:False:False,False,False
Bills,7,3,0,0,0,10,Texans,0,6,3,22,0,31,8:2009:False:False,False,False
Bears,6,10,7,7,0,30,Browns,0,0,6,0,0,6,8:2009:False:False,False,False
Cowboys,7,14,14,3,0,38,Seahawks,3,7,0,7,0,17,8:2009:False:False,False,False
Lions,0,2,0,8,0,10,Rams,3,7,0,7,0,17,8:2009:False:False,False,False
Ravens,3,3,10,14,0,30,Broncos,0,0,7,0,0,7,8:2009:False:False,False,False
Colts,3,6,3,6,0,18,49ers,7,7,0,0,0,14,8:2009:False:False,False,False
Eagles,13,17,3,7,0,40,Giants,0,7,10,0,0,17,8:2009:False:False,False,False
Jets,0,3,16,6,0,25,Dolphins,0,3,21,6,0,30,8:2009:False:False,False,False
Titans,3,10,10,7,0,30,Jaguars,0,7,6,0,0,13,8:2009:False:False,False,False
Chargers,7,14,0,3,0,24,Raiders,0,10,3,3,0,16,8:2009:False:False,False,False
Cardinals,7,0,7,7,0,21,Panthers,7,21,0,6,0,34,8:2009:False:False,False,False
Packers,3,0,17,6,0,26,Vikings,7,10,7,14,0,38,8:2009:False:False,False,False
Saints,7,21,0,7,0,35,Falcons,14,0,7,6,0,27,8:2009:False:False,False,False
Bears,7,0,0,14,0,21,Cardinals,14,17,3,7,0,41,9:2009:False:False,False,False
Bengals,14,3,0,0,0,17,Ravens,0,0,0,7,0,7,9:2009:False:False,False,False
Colts,10,3,0,7,0,20,Texans,0,3,7,7,0,17,9:2009:False:False,False,False
Jaguars,7,7,3,7,0,24,Chiefs,3,3,0,15,0,21,9:2009:False:False,False,False
Patriots,7,9,8,3,0,27,Dolphins,3,7,7,0,0,17,9:2009:False:False,False,False
Falcons,14,10,0,7,0,31,Redskins,0,3,7,7,0,17,9:2009:False:False,False,False
Buccaneers,7,10,0,21,0,38,Packers,14,7,0,7,0,28,9:2009:False:False,False,False
Seahawks,0,13,9,10,0,32,Lions,17,0,0,3,0,20,9:2009:False:False,False,False
Saints,0,6,14,10,0,30,Panthers,14,3,3,0,0,20,9:2009:False:False,False,False
Giants,0,7,0,13,0,20,Chargers,0,7,7,7,0,21,9:2009:False:False,False,False
49ers,3,14,0,10,0,27,Titans,3,7,7,17,0,34,9:2009:False:False,False,False
Eagles,0,6,7,3,0,16,Cowboys,7,3,0,10,0,20,9:2009:False:False,False,False
Broncos,3,0,7,0,0,10,Steelers,0,7,7,14,0,28,9:2009:False:False,False,False
49ers,0,7,0,3,0,10,Bears,0,3,3,0,0,6,10:2009:False:False,False,False
Panthers,7,14,0,7,0,28,Falcons,3,7,3,6,0,19,10:2009:False:False,False,False
Redskins,7,7,0,13,0,27,Broncos,14,3,0,0,0,17,10:2009:False:False,False,False
Titans,14,3,0,24,0,41,Bills,7,7,3,0,0,17,10:2009:False:False,False,False
Rams,0,14,3,6,0,23,Saints,0,14,7,7,0,28,10:2009:False:False,False,False
Steelers,3,6,0,3,0,12,Bengals,6,0,6,6,0,18,10:2009:False:False,False,False
Jets,10,3,0,9,0,22,Jaguars,7,14,0,3,0,24,10:2009:False:False,False,False
Dolphins,6,13,0,6,0,25,Buccaneers,3,3,3,14,0,23,10:2009:False:False,False,False
Vikings,3,7,7,10,0,27,Lions,0,3,7,0,0,10,10:2009:False:False,False,False
Raiders,10,0,0,0,0,10,Chiefs,3,10,0,3,0,16,10:2009:False:False,False,False
Packers,0,3,0,14,0,17,Cowboys,0,0,0,7,0,7,10:2009:False:False,False,False
Cardinals,0,10,7,14,0,31,Seahawks,7,10,0,3,0,20,10:2009:False:False,False,False
Chargers,7,7,14,3,0,31,Eagles,0,6,3,14,0,23,10:2009:False:False,False,False
Colts,7,7,0,21,0,35,Patriots,7,17,0,10,0,34,10:2009:False:False,False,False
Browns,0,0,0,0,0,0,Ravens,0,0,16,0,0,16,10:2009:False:False,False,False
Panthers,3,0,0,14,0,17,Dolphins,0,14,0,10,0,24,11:2009:False:False,False,False
Ravens,6,6,0,3,0,15,Colts,7,7,0,3,0,17,11:2009:False:False,False,False
Buccaneers,7,0,0,0,0,7,Saints,7,10,14,7,0,38,11:2009:False:False,False,False
Giants,3,14,7,7,3,34,Falcons,0,7,10,14,0,31,11:2009:False:False,False,False
Vikings,0,21,7,7,0,35,Seahawks,0,0,3,6,0,9,11:2009:False:False,False,False
Chiefs,7,0,10,7,3,27,Steelers,0,17,0,7,0,24,11:2009:False:False,False,False
Jaguars,3,7,0,8,0,18,Bills,6,3,6,0,0,15,11:2009:False:False,False,False
Cowboys,0,0,0,7,0,7,Redskins,0,3,3,0,0,6,11:2009:False:False,False,False
Lions,10,14,7,7,0,38,Browns,24,3,2,8,0,37,11:2009:False:False,False,False
Packers,6,17,0,7,0,30,49ers,3,0,7,14,0,24,11:2009:False:False,False,False
Rams,3,0,3,7,0,13,Cardinals,7,14,0,0,0,21,11:2009:False:False,False,False
Broncos,0,0,3,0,0,3,Chargers,7,6,7,12,0,32,11:2009:False:False,False,False
Raiders,0,7,3,10,0,20,Bengals,7,7,3,0,0,17,11:2009:False:False,False,False
Patriots,14,10,0,7,0,31,Jets,0,7,7,0,0,14,11:2009:False:False,False,False
Bears,0,9,11,0,0,20,Eagles,10,0,7,7,0,24,11:2009:False:False,False,False
Texans,7,7,3,0,0,17,Titans,0,14,3,3,0,20,11:2009:False:False,False,False
Lions,7,0,0,5,0,12,Packers,0,13,14,7,0,34,12:2009:False:False,False,False
Cowboys,3,14,0,7,0,24,Raiders,0,0,7,0,0,7,12:2009:False:False,False,False
Broncos,3,13,0,10,0,26,Giants,0,0,6,0,0,6,12:2009:False:False,False,False
Bengals,3,10,3,0,0,16,Browns,0,0,7,0,0,7,12:2009:False:False,False,False
Rams,0,10,0,7,0,17,Seahawks,7,7,3,10,0,27,12:2009:False:False,False,False
Eagles,10,6,0,11,0,27,Redskins,7,7,7,3,0,24,12:2009:False:False,False,False
Jets,7,7,0,3,0,17,Panthers,0,3,0,3,0,6,12:2009:False:False,False,False
Falcons,0,10,3,7,0,20,Buccaneers,0,10,7,0,0,17,12:2009:False:False,False,False
Bills,0,7,0,24,0,31,Dolphins,0,7,7,0,0,14,12:2009:False:False,False,False
Texans,14,6,0,7,0,27,Colts,0,7,7,21,0,35,12:2009:False:False,False,False
Chargers,7,21,10,5,0,43,Chiefs,0,7,7,0,0,14,12:2009:False:False,False,False
49ers,3,14,3,0,0,20,Jaguars,0,3,0,0,0,3,12:2009:False:False,False,False
Vikings,0,24,3,9,0,36,Bears,0,7,3,0,0,10,12:2009:False:False,False,False
Titans,3,3,7,7,0,20,Cardinals,0,3,7,7,0,17,12:2009:False:False,False,False
Ravens,7,7,0,3,3,20,Steelers,0,7,3,7,0,17,12:2009:False:False,False,False
Saints,3,21,7,7,0,38,Patriots,7,3,7,0,0,17,12:2009:False:False,False,False
Bills,3,7,0,3,0,13,Jets,3,13,0,3,0,19,13:2009:False:False,False,False
Falcons,0,0,0,7,0,7,Eagles,10,3,14,7,0,34,13:2009:False:False,False,False
Dolphins,0,10,9,3,0,22,Patriots,7,7,7,0,0,21,13:2009:False:False,False,False
Redskins,10,7,10,3,0,30,Saints,0,17,3,10,3,33,13:2009:False:False,False,False
Steelers,3,7,0,14,0,24,Raiders,3,3,0,21,0,27,13:2009:False:False,False,False
Chiefs,0,6,0,7,0,13,Broncos,7,7,20,10,0,44,13:2009:False:False,False,False
Panthers,10,0,3,3,0,16,Buccaneers,0,6,0,0,0,6,13:2009:False:False,False,False
Bears,10,0,7,0,0,17,Rams,0,3,3,3,0,9,13:2009:False:False,False,False
Bengals,0,17,3,3,0,23,Lions,7,0,0,6,0,13,13:2009:False:False,False,False
Colts,7,17,0,3,0,27,Titans,3,7,0,7,0,17,13:2009:False:False,False,False
Jaguars,3,17,3,0,0,23,Texans,0,7,5,6,0,18,13:2009:False:False,False,False
Browns,7,0,0,16,0,23,Chargers,10,3,14,3,0,30,13:2009:False:False,False,False
Seahawks,7,7,0,6,0,20,49ers,7,7,0,3,0,17,13:2009:False:False,False,False
Giants,0,14,7,10,0,31,Cowboys,0,10,7,7,0,24,13:2009:False:False,False,False
Cardinals,7,14,6,3,0,30,Vikings,7,3,0,7,0,17,13:2009:False:False,False,False
Packers,3,14,0,10,0,27,Ravens,0,0,14,0,0,14,13:2009:False:False,False,False
Browns,3,10,0,0,0,13,Steelers,0,3,3,0,0,6,14:2009:False:False,False,False
Texans,17,7,10,0,0,34,Seahawks,0,7,0,0,0,7,14:2009:False:False,False,False
Chiefs,0,3,7,0,0,10,Bills,7,3,3,3,0,16,14:2009:False:False,False,False
Vikings,0,16,7,7,0,30,Bengals,0,7,0,3,0,10,14:2009:False:False,False,False
Patriots,0,7,7,6,0,20,Panthers,7,0,0,3,0,10,14:2009:False:False,False,False
Buccaneers,0,0,3,0,0,3,Jets,6,13,0,7,0,26,14:2009:False:False,False,False
Colts,14,7,0,7,0,28,Broncos,0,7,0,9,0,16,14:2009:False:False,False,False
Jaguars,0,7,3,0,0,10,Dolphins,7,7,0,0,0,14,14:2009:False:False,False,False
Bears,0,7,7,0,0,14,Packers,10,3,0,8,0,21,14:2009:False:False,False,False
Ravens,3,17,21,7,0,48,Lions,0,3,0,0,0,3,14:2009:False:False,False,False
Falcons,6,3,7,7,0,23,Saints,3,13,7,3,0,26,14:2009:False:False,False,False
Titans,14,9,10,14,0,47,Rams,0,0,0,7,0,7,14:2009:False:False,False,False
Raiders,3,7,3,0,0,13,Redskins,7,10,0,17,0,34,14:2009:False:False,False,False
Cowboys,3,0,7,7,0,17,Chargers,7,3,0,10,0,20,14:2009:False:False,False,False
Giants,3,14,14,7,0,38,Eagles,14,16,7,8,0,45,14:2009:False:False,False,False
49ers,10,7,0,7,0,24,Cardinals,0,0,3,6,0,9,14:2009:False:False,False,False
Jaguars,3,14,14,0,0,31,Colts,0,21,7,7,0,35,15:2009:False:False,False,False
Saints,0,3,0,14,0,17,Cowboys,14,3,7,0,0,24,15:2009:False:False,False,False
Jets,7,0,0,0,0,7,Falcons,3,0,0,7,0,10,15:2009:False:False,False,False
Titans,7,10,7,0,3,27,Dolphins,3,3,3,15,0,24,15:2009:False:False,False,False
Rams,0,10,3,0,0,13,Texans,3,3,7,3,0,16,15:2009:False:False,False,False
Chiefs,3,21,0,10,0,34,Browns,10,10,7,14,0,41,15:2009:False:False,False,False
Lions,0,0,17,7,0,24,Cardinals,7,10,0,14,0,31,15:2009:False:False,False,False
Bills,3,0,0,7,0,10,Patriots,0,14,3,0,0,17,15:2009:False:False,False,False
Chargers,7,7,10,3,0,27,Bengals,3,10,0,11,0,24,15:2009:False:False,False,False
Broncos,6,0,10,3,0,19,Raiders,0,13,0,7,0,20,15:2009:False:False,False,False
Steelers,14,7,3,13,0,37,Packers,7,7,0,22,0,36,15:2009:False:False,False,False
Eagles,7,13,0,7,0,27,49ers,3,0,10,0,0,13,15:2009:False:False,False,False
Ravens,14,0,17,0,0,31,Bears,0,7,0,0,0,7,15:2009:False:False,False,False
Seahawks,0,7,0,0,0,7,Buccaneers,0,3,18,3,0,24,15:2009:False:False,False,False
Panthers,0,6,0,20,0,26,Vikings,0,7,0,0,0,7,15:2009:False:False,False,False
Redskins,0,0,12,0,0,12,Giants,7,17,14,7,0,45,15:2009:False:False,False,False
Titans,3,7,0,7,0,17,Chargers,7,14,14,7,0,42,16:2009:False:False,False,False
Falcons,7,3,14,7,0,31,Bills,0,0,3,0,0,3,16:2009:False:False,False,False
Steelers,6,14,0,3,0,23,Ravens,3,7,10,0,0,20,16:2009:False:False,False,False
Saints,14,3,0,0,0,17,Buccaneers,0,3,0,14,3,20,16:2009:False:False,False,False
Patriots,7,21,0,7,0,35,Jaguars,0,0,0,7,0,7,16:2009:False:False,False,False
Giants,0,0,3,6,0,9,Panthers,3,21,10,7,0,41,16:2009:False:False,False,False
Dolphins,0,3,7,10,0,20,Texans,10,17,0,0,0,27,16:2009:False:False,False,False
Bengals,0,3,7,7,0,17,Chiefs,0,3,0,7,0,10,16:2009:False:False,False,False
Browns,10,7,3,3,0,23,Raiders,3,6,0,0,0,9,16:2009:False:False,False,False
Packers,14,10,14,10,0,48,Seahawks,0,3,0,7,0,10,16:2009:False:False,False,False
Cardinals,0,17,7,7,0,31,Rams,0,0,7,3,0,10,16:2009:False:False,False,False
49ers,3,3,14,0,0,20,Lions,3,0,0,3,0,6,16:2009:False:False,False,False
Eagles,10,10,7,3,0,30,Broncos,0,7,17,3,0,27,16:2009:False:False,False,False
Colts,6,3,6,0,0,15,Jets,0,3,15,11,0,29,16:2009:False:False,False,False
Redskins,0,0,0,0,0,0,Cowboys,7,7,0,3,0,17,16:2009:False:False,False,False
Bears,3,13,7,7,6,36,Vikings,0,0,13,17,0,30,16:2009:False:False,False,False
Bills,7,17,6,0,0,30,Colts,7,0,0,0,0,7,17:2009:False:False,False,False
Panthers,7,10,6,0,0,23,Saints,0,3,7,0,0,10,17:2009:False:False,False,False
Buccaneers,3,0,0,7,0,10,Falcons,0,10,0,10,0,20,17:2009:False:False,False,False
Rams,0,3,0,3,0,6,49ers,0,0,7,21,0,28,17:2009:False:False,False,False
Vikings,7,24,13,0,0,44,Giants,0,0,0,7,0,7,17:2009:False:False,False,False
Dolphins,7,3,0,14,0,24,Steelers,14,3,7,6,0,30,17:2009:False:False,False,False
Texans,7,6,0,21,0,34,Patriots,7,6,7,7,0,27,17:2009:False:False,False,False
Lions,3,7,3,10,0,23,Bears,3,10,7,17,0,37,17:2009:False:False,False,False
Browns,3,10,7,3,0,23,Jaguars,3,0,0,14,0,17,17:2009:False:False,False,False
Broncos,0,10,14,0,0,24,Chiefs,7,3,17,17,0,44,17:2009:False:False,False,False
Cardinals,0,0,0,7,0,7,Packers,14,12,7,0,0,33,17:2009:False:False,False,False
Chargers,10,3,0,10,0,23,Redskins,0,14,3,3,0,20,17:2009:False:False,False,False
Raiders,0,10,3,0,0,13,Ravens,7,7,0,7,0,21,17:2009:False:False,False,False
Cowboys,7,10,7,0,0,24,Eagles,0,0,0,0,0,0,17:2009:False:False,False,False
Seahawks,0,7,3,3,0,13,Titans,7,0,3,7,0,17,17:2009:False:False,False,False
Jets,7,20,3,7,0,37,Bengals,0,0,0,0,0,0,17:2009:False:False,False,False
Bengals,7,0,0,7,0,14,Jets,0,14,7,3,0,24,18:2009:False:True,False,True
Cowboys,0,27,7,0,0,34,Eagles,0,7,0,7,0,14,18:2009:False:True,False,True
Patriots,0,7,7,0,0,14,Ravens,24,0,3,6,0,33,18:2009:False:True,False,True
Cardinals,17,7,14,7,6,51,Packers,0,10,14,21,0,45,18:2009:False:True,False,True
Saints,21,14,10,0,0,45,Cardinals,7,7,0,0,0,14,19:2009:False:True,False,True
Colts,3,14,0,3,0,20,Ravens,3,0,0,0,0,3,19:2009:False:True,False,True
Vikings,7,10,0,17,0,34,Cowboys,0,3,0,0,0,3,19:2009:False:True,False,True
Chargers,0,7,0,7,0,14,Jets,0,0,3,14,0,17,19:2009:False:True,False,True
Colts,0,13,7,10,0,30,Jets,0,17,0,0,0,17,20:2009:False:True,False,True
Saints,7,7,7,7,3,31,Vikings,14,0,7,7,0,28,20:2009:False:True,False,True
Colts,10,0,7,0,0,17,Saints,0,6,10,15,0,31,22:2009:False:True,False,True
Patriots,10,7,7,3,0,27,Saints,0,7,14,3,0,24,1:2010:True:False,True,False
Ravens,3,7,7,0,0,17,Panthers,0,3,6,3,0,12,1:2010:True:False,True,False
Cowboys,3,0,3,3,0,9,Raiders,0,0,0,17,0,17,1:2010:True:False,True,False
Eagles,6,10,3,9,0,28,Jaguars,0,17,10,0,0,27,1:2010:True:False,True,False
Redskins,7,14,14,7,0,42,Bills,3,0,7,7,0,17,1:2010:True:False,True,False
Falcons,3,0,7,10,0,20,Chiefs,0,3,0,7,0,10,1:2010:True:False,True,False
Dolphins,0,3,7,0,0,10,Buccaneers,7,0,0,0,0,7,1:2010:True:False,True,False
Steelers,3,10,3,7,0,23,Lions,0,7,0,0,0,7,1:2010:True:False,True,False
Rams,7,0,0,0,0,7,Vikings,0,14,7,7,0,28,1:2010:True:False,True,False
Cardinals,0,0,0,19,0,19,Texans,10,3,3,0,0,16,1:2010:True:False,True,False
Packers,7,7,7,3,0,24,Browns,14,7,0,6,0,27,1:2010:True:False,True,False
Chargers,7,7,8,3,0,25,Bears,3,7,0,0,0,10,1:2010:True:False,True,False
Seahawks,0,10,10,0,0,20,Titans,7,0,0,11,0,18,1:2010:True:False,True,False
Colts,10,0,0,7,0,17,49ers,0,20,7,10,0,37,1:2010:True:False,True,False
Bengals,0,17,6,10,0,33,Broncos,14,3,0,7,0,24,1:2010:True:False,True,False
Jets,10,3,3,0,0,16,Giants,7,3,7,14,0,31,1:2010:True:False,True,False
Bills,21,3,0,10,0,34,Colts,14,7,0,0,0,21,2:2010:True:False,True,False
Falcons,3,0,0,7,0,10,Patriots,7,7,7,7,0,28,2:2010:True:False,True,False
Bengals,0,7,0,15,0,22,Eagles,0,6,3,0,0,9,2:2010:True:False,True,False
Giants,0,7,0,10,0,17,Steelers,0,10,14,0,0,24,2:2010:True:False,True,False
Redskins,3,0,0,0,0,3,Ravens,0,13,7,3,0,23,2:2010:True:False,True,False
Browns,0,10,7,0,0,17,Rams,13,0,0,6,0,19,2:2010:True:False,True,False
Jaguars,9,3,7,7,0,26,Dolphins,3,21,0,3,0,27,2:2010:True:False,True,False
Buccaneers,3,7,0,10,0,20,Chiefs,7,3,3,2,0,15,2:2010:True:False,True,False
Saints,14,14,7,3,0,38,Texans,0,10,3,7,0,20,2:2010:True:False,True,False
Panthers,0,0,3,0,0,3,Jets,3,3,0,3,0,9,2:2010:True:False,True,False
Bears,6,8,0,3,0,17,Raiders,10,3,14,5,0,32,2:2010:True:False,True,False
Chargers,7,0,7,0,0,14,Cowboys,0,7,0,9,0,16,2:2010:True:False,True,False
Broncos,0,14,3,3,0,20,Lions,10,6,0,9,0,25,2:2010:True:False,True,False
Seahawks,7,7,7,3,0,24,Packers,14,3,0,10,0,27,2:2010:True:False,True,False
49ers,7,0,3,5,0,15,Vikings,0,3,0,7,0,10,2:2010:True:False,True,False
Titans,7,3,14,0,0,24,Cardinals,0,3,0,7,0,10,2:2010:True:False,True,False
Patriots,7,7,7,14,0,35,Rams,7,13,7,9,0,36,3:2010:True:False,True,False
Packers,7,21,10,21,0,59,Colts,10,7,7,0,0,24,3:2010:True:False,True,False
Jets,3,2,0,6,0,11,Redskins,3,3,3,7,0,16,3:2010:True:False,True,False
Dolphins,3,0,3,0,0,6,Falcons,7,3,6,0,0,16,3:2010:True:False,True,False
Saints,7,10,3,16,0,36,Chargers,7,7,0,7,0,21,3:2010:True:False,True,False
Chiefs,0,7,7,3,0,17,Eagles,10,0,0,10,0,20,3:2010:True:False,True,False
Lions,7,7,7,14,0,35,Browns,10,14,3,0,0,27,3:2010:True:False,True,False
Bills,7,14,7,7,0,35,Bengals,7,7,6,0,0,20,3:2010:True:False,True,False
Ravens,3,14,0,7,0,24,Giants,0,3,0,7,0,10,3:2010:True:False,True,False
Buccaneers,3,7,3,0,0,13,Jaguars,3,3,10,3,0,19,3:2010:True:False,True,False
Texans,7,6,10,0,0,23,Cowboys,0,0,0,7,0,7,3:2010:True:False,True,False
Panthers,0,0,3,12,0,15,Titans,0,0,0,7,0,7,3:2010:True:False,True,False
Vikings,0,10,0,14,0,24,Seahawks,0,10,3,0,0,13,3:2010:True:False,True,False
Bears,0,0,0,9,0,9,Cardinals,0,7,7,0,0,14,3:2010:True:False,True,False
Raiders,7,7,10,0,0,24,49ers,0,17,3,8,0,28,3:2010:True:False,True,False
Broncos,7,10,3,14,0,34,Steelers,3,0,0,14,0,17,3:2010:True:False,True,False
Lions,0,7,7,14,0,28,Bills,10,6,0,7,0,23,4:2010:True:False,True,False
Colts,0,6,7,15,0,28,Bengals,6,0,14,10,0,30,4:2010:True:False,True,False
Giants,6,3,3,8,0,20,Patriots,7,3,0,7,0,17,4:2010:True:False,True,False
Jaguars,0,10,3,0,0,13,Falcons,0,6,0,3,0,9,4:2010:True:False,True,False
Steelers,3,10,3,3,0,19,Panthers,0,0,0,3,0,3,4:2010:True:False,True,False
Eagles,10,7,0,0,0,17,Jets,0,7,7,7,0,21,4:2010:True:False,True,False
Rams,14,3,3,7,0,27,Ravens,0,7,7,7,0,21,4:2010:True:False,True,False
Browns,7,3,0,3,0,13,Bears,7,3,0,0,0,10,4:2010:True:False,True,False
Texans,0,0,10,7,0,17,Buccaneers,3,14,0,7,0,24,4:2010:True:False,True,False
Titans,7,6,0,14,0,27,Saints,3,7,3,11,0,24,4:2010:True:False,True,False
Vikings,7,10,7,7,0,31,Broncos,7,0,7,10,0,24,4:2010:True:False,True,False
Chiefs,7,7,3,0,0,17,Packers,0,3,7,3,0,13,4:2010:True:False,True,False
Cowboys,0,10,6,11,0,27,Dolphins,3,7,0,15,0,25,4:2010:True:False,True,False
49ers,7,3,0,7,0,17,Chargers,0,0,14,0,0,14,4:2010:True:False,True,False
Raiders,17,0,7,3,0,27,Seahawks,3,13,0,8,0,24,4:2010:True:False,True,False
Cardinals,3,7,10,0,0,20,Redskins,3,0,0,7,0,10,4:2010:True:False,True,False
Saints,7,0,7,0,0,14,Vikings,0,9,0,0,0,9,1:2010:False:False,False,False
Texans,6,7,7,14,0,34,Colts,0,10,0,14,0,24,1:2010:False:False,False,False
Jaguars,0,7,10,7,0,24,Broncos,0,7,7,3,0,17,1:2010:False:False,False,False
Titans,10,14,7,7,0,38,Raiders,3,3,0,7,0,13,1:2010:False:False,False,False
Giants,7,7,10,7,0,31,Panthers,3,13,0,2,0,18,1:2010:False:False,False,False
Bears,3,10,0,6,0,19,Lions,7,7,0,0,0,14,1:2010:False:False,False,False
Patriots,10,14,7,7,0,38,Bengals,0,3,14,7,0,24,1:2010:False:False,False,False
Bills,0,3,0,7,0,10,Dolphins,3,7,0,5,0,15,1:2010:False:False,False,False
Buccaneers,3,7,0,7,0,17,Browns,7,7,0,0,0,14,1:2010:False:False,False,False
Steelers,3,0,3,3,6,15,Falcons,0,3,3,3,0,9,1:2010:False:False,False,False
Eagles,3,0,7,10,0,20,Packers,0,13,14,0,0,27,1:2010:False:False,False,False
Seahawks,0,14,14,3,0,31,49ers,3,3,0,0,0,6,1:2010:False:False,False,False
Rams,0,10,3,0,0,13,Cardinals,0,10,0,7,0,17,1:2010:False:False,False,False
Redskins,3,7,0,3,0,13,Cowboys,0,0,7,0,0,7,1:2010:False:False,False,False
Jets,3,3,0,3,0,9,Ravens,0,7,3,0,0,10,1:2010:False:False,False,False
Chiefs,7,14,0,0,0,21,Chargers,7,0,7,0,0,14,1:2010:False:False,False,False
Packers,13,0,14,7,0,34,Bills,0,7,0,0,0,7,2:2010:False:False,False,False
Bengals,0,6,3,6,0,15,Ravens,0,0,7,3,0,10,2:2010:False:False,False,False
Panthers,0,7,0,0,0,7,Buccaneers,7,7,3,3,0,20,2:2010:False:False,False,False
Falcons,7,17,10,7,0,41,Cardinals,0,7,0,0,0,7,2:2010:False:False,False,False
Lions,7,10,0,15,0,32,Eagles,7,14,7,7,0,35,2:2010:False:False,False,False
Cowboys,7,7,3,3,0,20,Bears,10,10,0,7,0,27,2:2010:False:False,False,False
Vikings,0,0,7,3,0,10,Dolphins,7,0,7,0,0,14,2:2010:False:False,False,False
Browns,0,14,0,0,0,14,Chiefs,3,7,3,3,0,16,2:2010:False:False,False,False
Titans,3,0,0,8,0,11,Steelers,7,6,0,6,0,19,2:2010:False:False,False,False
Raiders,0,3,10,3,0,16,Rams,0,7,0,7,0,14,2:2010:False:False,False,False
Broncos,7,10,7,7,0,31,Seahawks,0,0,7,7,0,14,2:2010:False:False,False,False
Jets,0,10,11,7,0,28,Patriots,0,14,0,0,0,14,2:2010:False:False,False,False
Chargers,7,14,3,14,0,38,Jaguars,3,3,0,7,0,13,2:2010:False:False,False,False
Redskins,6,14,7,0,0,27,Texans,0,7,10,10,3,30,2:2010:False:False,False,False
Colts,7,17,7,7,0,38,Giants,0,0,7,7,0,14,2:2010:False:False,False,False
49ers,0,7,7,8,0,22,Saints,9,0,7,9,0,25,2:2010:False:False,False,False
Panthers,0,0,7,0,0,7,Bengals,7,3,0,10,0,20,3:2010:False:False,False,False
Buccaneers,3,3,0,7,0,13,Steelers,7,21,3,7,0,38,3:2010:False:False,False,False
Patriots,7,10,14,7,0,38,Bills,3,13,7,7,0,30,3:2010:False:False,False,False
Chiefs,0,10,14,7,0,31,49ers,0,3,0,7,0,10,3:2010:False:False,False,False
Vikings,7,7,10,0,0,24,Lions,7,3,0,0,0,10,3:2010:False:False,False,False
Saints,14,0,7,3,0,24,Falcons,7,7,3,7,3,27,3:2010:False:False,False,False
Texans,0,3,0,10,0,13,Cowboys,0,10,7,10,0,27,3:2010:False:False,False,False
Giants,0,10,0,0,0,10,Titans,3,7,9,10,0,29,3:2010:False:False,False,False
Ravens,7,7,0,10,0,24,Browns,3,7,0,7,0,17,3:2010:False:False,False,False
Jaguars,0,3,0,0,0,3,Eagles,7,7,14,0,0,28,3:2010:False:False,False,False
Rams,14,0,7,9,0,30,Redskins,0,13,3,0,0,16,3:2010:False:False,False,False
Cardinals,10,7,7,0,0,24,Raiders,13,7,0,3,0,23,3:2010:False:False,False,False
Seahawks,0,10,7,10,0,27,Chargers,0,0,12,8,0,20,3:2010:False:False,False,False
Broncos,0,3,10,0,0,13,Colts,6,7,7,7,0,27,3:2010:False:False,False,False
Dolphins,0,10,10,3,0,23,Jets,7,7,7,10,0,31,3:2010:False:False,False,False
Bears,0,7,0,13,0,20,Packers,7,3,0,7,0,17,3:2010:False:False,False,False
Browns,3,10,10,0,0,23,Bengals,0,10,3,7,0,20,4:2010:False:False,False,False
Steelers,7,0,0,7,0,14,Ravens,0,10,0,7,0,17,4:2010:False:False,False,False
Titans,0,10,10,0,0,20,Broncos,0,10,6,10,0,26,4:2010:False:False,False,False
Packers,7,14,7,0,0,28,Lions,0,14,6,6,0,26,4:2010:False:False,False,False
Falcons,0,10,3,3,0,16,49ers,14,0,0,0,0,14,4:2010:False:False,False,False
Rams,7,3,7,3,0,20,Seahawks,0,3,0,0,0,3,4:2010:False:False,False,False
Bills,0,7,0,7,0,14,Jets,7,10,21,0,0,38,4:2010:False:False,False,False
Saints,0,10,3,3,0,16,Panthers,0,7,7,0,0,14,4:2010:False:False,False,False
Raiders,7,7,0,10,0,24,Texans,14,0,10,7,0,31,4:2010:False:False,False,False
Jaguars,7,7,7,10,0,31,Colts,7,7,0,14,0,28,4:2010:False:False,False,False
Eagles,0,6,0,6,0,12,Redskins,14,3,0,0,0,17,4:2010:False:False,False,False
Chargers,7,21,10,3,0,41,Cardinals,0,7,0,3,0,10,4:2010:False:False,False,False
Giants,3,0,7,7,0,17,Bears,0,0,0,3,0,3,4:2010:False:False,False,False
Dolphins,7,0,7,0,0,14,Patriots,0,6,21,14,0,41,4:2010:False:False,False,False
Ravens,7,10,0,14,0,31,Broncos,0,7,0,10,0,17,5:2010:False:False,False,False
Colts,3,3,3,10,0,19,Chiefs,0,3,6,0,0,9,5:2010:False:False,False,False
Redskins,0,3,0,10,3,16,Packers,7,3,3,0,0,13,5:2010:False:False,False,False
Lions,3,21,7,13,0,44,Rams,3,3,0,0,0,6,5:2010:False:False,False,False
Panthers,3,0,3,0,0,6,Bears,17,0,0,6,0,23,5:2010:False:False,False,False
Browns,0,7,3,0,0,10,Falcons,0,6,7,7,0,20,5:2010:False:False,False,False
Texans,0,3,7,0,0,10,Giants,14,10,3,7,0,34,5:2010:False:False,False,False
Bills,10,3,7,6,0,26,Jaguars,3,10,14,9,0,36,5:2010:False:False,False,False
Bengals,7,3,3,8,0,21,Buccaneers,0,7,7,10,0,24,5:2010:False:False,False,False
Cardinals,0,10,3,17,0,30,Saints,10,3,0,7,0,20,5:2010:False:False,False,False
Cowboys,3,7,7,10,0,27,Titans,10,7,3,14,0,34,5:2010:False:False,False,False
Raiders,12,3,7,13,0,35,Chargers,0,17,7,3,0,27,5:2010:False:False,False,False
49ers,7,3,0,14,0,24,Eagles,7,10,0,10,0,27,5:2010:False:False,False,False
Jets,3,6,6,14,0,29,Vikings,0,0,7,13,0,20,5:2010:False:False,False,False
Rams,10,7,0,3,0,20,Chargers,0,3,7,7,0,17,6:2010:False:False,False,False
Patriots,7,0,3,10,3,23,Ravens,3,7,7,3,0,20,6:2010:False:False,False,False
Steelers,0,7,7,14,0,28,Browns,3,0,0,7,0,10,6:2010:False:False,False,False
Texans,0,7,7,21,0,35,Chiefs,7,7,10,7,0,31,6:2010:False:False,False,False
Giants,7,7,7,7,0,28,Lions,7,3,0,10,0,20,6:2010:False:False,False,False
Bears,7,6,0,7,0,20,Seahawks,7,7,2,7,0,23,6:2010:False:False,False,False
Buccaneers,0,0,0,6,0,6,Saints,7,10,7,7,0,31,6:2010:False:False,False,False
Packers,10,0,0,10,0,20,Dolphins,7,3,3,7,3,23,6:2010:False:False,False,False
Eagles,14,7,7,3,0,31,Falcons,0,7,3,7,0,17,6:2010:False:False,False,False
49ers,0,3,7,7,0,17,Raiders,3,3,0,3,0,9,6:2010:False:False,False,False
Broncos,0,10,7,3,0,20,Jets,0,7,3,14,0,24,6:2010:False:False,False,False
Vikings,7,0,14,3,0,24,Cowboys,7,7,0,7,0,21,6:2010:False:False,False,False
Redskins,7,0,10,7,0,24,Colts,7,10,7,3,0,27,6:2010:False:False,False,False
Jaguars,0,0,3,0,0,3,Titans,7,10,3,10,0,30,6:2010:False:False,False,False
Dolphins,6,10,3,3,0,22,Steelers,0,17,3,3,0,23,7:2010:False:False,False,False
Ravens,3,17,14,0,3,37,Bills,10,14,0,10,0,34,7:2010:False:False,False,False
Chiefs,7,7,14,14,0,42,Jaguars,3,10,7,0,0,20,7:2010:False:False,False,False
Saints,0,3,0,14,0,17,Browns,10,10,0,10,0,30,7:2010:False:False,False,False
Bears,7,7,0,0,0,14,Redskins,7,3,7,0,0,17,7:2010:False:False,False,False
Buccaneers,3,3,6,6,0,18,Rams,0,17,0,0,0,17,7:2010:False:False,False,False
Titans,0,7,3,27,0,37,Eagles,0,13,3,3,0,19,7:2010:False:False,False,False
Falcons,7,17,0,15,0,39,Bengals,3,0,22,7,0,32,7:2010:False:False,False,False
Panthers,3,7,3,10,0,23,49ers,7,3,0,10,0,20,7:2010:False:False,False,False
Seahawks,3,7,9,3,0,22,Cardinals,0,0,7,3,0,10,7:2010:False:False,False,False
Chargers,3,0,0,17,0,20,Patriots,7,6,7,3,0,23,7:2010:False:False,False,False
Broncos,0,7,7,0,0,14,Raiders,24,14,21,0,0,59,7:2010:False:False,False,False
Packers,7,7,14,0,0,28,Vikings,7,10,7,0,0,24,7:2010:False:False,False,False
Cowboys,10,10,0,15,0,35,Giants,7,17,14,3,0,41,7:2010:False:False,False,False
Cowboys,3,0,0,14,0,17,Jaguars,7,7,14,7,0,35,8:2010:False:False,False,False
Bengals,7,7,0,0,0,14,Dolphins,3,9,3,7,0,22,8:2010:False:False,False,False
Chiefs,0,7,0,3,3,13,Bills,0,0,3,7,0,10,8:2010:False:False,False,False
Lions,0,7,7,23,0,37,Redskins,0,13,0,12,0,25,8:2010:False:False,False,False
Rams,0,10,0,10,0,20,Panthers,0,3,0,7,0,10,8:2010:False:False,False,False
49ers,3,0,0,21,0,24,Broncos,0,0,7,9,0,16,8:2010:False:False,False,False
Jets,0,0,0,0,0,0,Packers,3,0,0,6,0,9,8:2010:False:False,False,False
Chargers,7,7,10,9,0,33,Titans,5,14,0,6,0,25,8:2010:False:False,False,False
Patriots,0,7,14,7,0,28,Vikings,0,7,3,8,0,18,8:2010:False:False,False,False
Cardinals,7,7,14,7,0,35,Buccaneers,7,17,7,7,0,38,8:2010:False:False,False,False
Raiders,3,7,3,20,0,33,Seahawks,0,0,0,3,0,3,8:2010:False:False,False,False
Saints,0,3,3,14,0,20,Steelers,0,3,0,7,0,10,8:2010:False:False,False,False
Colts,7,10,10,3,0,30,Texans,0,3,7,7,0,17,8:2010:False:False,False,False
Ravens,7,6,7,6,0,26,Dolphins,7,3,0,0,0,10,9:2010:False:False,False,False
Browns,10,7,7,10,0,34,Patriots,0,7,0,7,0,14,9:2010:False:False,False,False
Texans,10,10,3,0,0,23,Chargers,14,0,7,8,0,29,9:2010:False:False,False,False
Bills,0,7,6,6,0,19,Bears,0,7,7,8,0,22,9:2010:False:False,False,False
Vikings,0,10,0,14,3,27,Cardinals,0,14,7,3,0,24,9:2010:False:False,False,False
Panthers,3,0,0,0,0,3,Saints,7,10,10,7,0,34,9:2010:False:False,False,False
Lions,7,0,6,7,0,20,Jets,0,10,0,10,3,23,9:2010:False:False,False,False
Falcons,7,10,10,0,0,27,Buccaneers,0,14,7,0,0,21,9:2010:False:False,False,False
Seahawks,0,0,0,7,0,7,Giants,21,14,6,0,0,41,9:2010:False:False,False,False
Eagles,13,3,3,7,0,26,Colts,0,17,0,7,0,24,9:2010:False:False,False,False
Raiders,0,0,14,6,3,23,Chiefs,0,10,3,7,0,20,9:2010:False:False,False,False
Packers,0,28,7,10,0,45,Cowboys,0,7,0,0,0,7,9:2010:False:False,False,False
Bengals,0,7,0,14,0,21,Steelers,10,10,0,7,0,27,9:2010:False:False,False,False
Falcons,0,10,3,13,0,26,Ravens,0,0,7,14,0,21,10:2010:False:False,False,False
Buccaneers,7,14,0,10,0,31,Panthers,3,7,6,0,0,16,10:2010:False:False,False,False
Jaguars,3,14,0,14,0,31,Texans,3,0,14,7,0,24,10:2010:False:False,False,False
Colts,10,10,0,3,0,23,Bengals,0,10,0,7,0,17,10:2010:False:False,False,False
Browns,10,3,0,7,0,20,Jets,3,14,0,3,6,26,10:2010:False:False,False,False
Dolphins,7,3,10,9,0,29,Titans,10,0,7,0,0,17,10:2010:False:False,False,False
Bears,0,14,6,7,0,27,Vikings,3,7,3,0,0,13,10:2010:False:False,False,False
Bills,0,7,7,0,0,14,Lions,0,3,0,9,0,12,10:2010:False:False,False,False
Broncos,21,14,7,7,0,49,Chiefs,0,10,7,12,0,29,10:2010:False:False,False,False
49ers,7,3,0,10,3,23,Rams,3,7,7,3,0,20,10:2010:False:False,False,False
Cardinals,7,3,0,8,0,18,Seahawks,7,10,9,10,0,36,10:2010:False:False,False,False
Giants,3,3,14,0,0,20,Cowboys,6,13,14,0,0,33,10:2010:False:False,False,False
Steelers,0,3,0,23,0,26,Patriots,10,0,13,16,0,39,10:2010:False:False,False,False
Redskins,0,14,7,7,0,28,Eagles,28,17,14,0,0,59,10:2010:False:False,False,False
Dolphins,0,0,0,0,0,0,Bears,3,3,10,0,0,16,11:2010:False:False,False,False
Panthers,0,3,3,7,0,13,Ravens,10,7,3,17,0,37,11:2010:False:False,False,False
Chiefs,0,14,7,10,0,31,Cardinals,3,0,3,7,0,13,11:2010:False:False,False,False
Titans,7,3,3,3,0,16,Redskins,7,3,3,3,3,19,11:2010:False:False,False,False
Vikings,3,0,0,0,0,3,Packers,0,17,7,7,0,31,11:2010:False:False,False,False
Cowboys,7,0,14,14,0,35,Lions,0,10,9,0,0,19,11:2010:False:False,False,False
Jaguars,3,7,0,14,0,24,Browns,0,7,10,3,0,20,11:2010:False:False,False,False
Jets,3,10,7,10,0,30,Texans,0,7,0,20,0,27,11:2010:False:False,False,False
Bengals,7,24,0,0,0,31,Bills,7,7,14,21,0,49,11:2010:False:False,False,False
Steelers,0,21,0,14,0,35,Raiders,3,0,0,0,0,3,11:2010:False:False,False,False
Rams,7,3,7,0,0,17,Falcons,3,13,7,11,0,34,11:2010:False:False,False,False
Saints,7,20,7,0,0,34,Seahawks,3,13,0,3,0,19,11:2010:False:False,False,False
49ers,0,0,0,0,0,0,Buccaneers,0,7,7,7,0,21,11:2010:False:False,False,False
Patriots,7,14,7,3,0,31,Colts,0,14,0,14,0,28,11:2010:False:False,False,False
Eagles,7,6,3,11,0,27,Giants,0,3,7,7,0,17,11:2010:False:False,False,False
Chargers,7,14,7,7,0,35,Broncos,7,0,0,7,0,14,11:2010:False:False,False,False
Lions,7,10,7,0,0,24,Patriots,3,7,14,21,0,45,12:2010:False:False,False,False
Cowboys,0,6,14,7,0,27,Saints,17,3,3,7,0,30,12:2010:False:False,False,False
Jets,0,3,14,9,0,26,Bengals,0,7,0,3,0,10,12:2010:False:False,False,False
Texans,0,14,3,3,0,20,Titans,0,0,0,0,0,0,12:2010:False:False,False,False
Browns,14,7,0,3,0,24,Panthers,7,6,7,3,0,23,12:2010:False:False,False,False
Falcons,3,7,0,10,0,20,Packers,3,0,7,7,0,17,12:2010:False:False,False,False
Redskins,7,0,0,6,0,13,Vikings,7,0,10,0,0,17,12:2010:False:False,False,False
Bills,0,0,7,9,0,16,Steelers,7,6,0,3,3,19,12:2010:False:False,False,False
Giants,3,3,3,15,0,24,Jaguars,7,10,0,3,0,20,12:2010:False:False,False,False
Seahawks,7,3,7,7,0,24,Chiefs,7,14,0,21,0,42,12:2010:False:False,False,False
Raiders,7,7,0,3,0,17,Dolphins,10,3,10,10,0,33,12:2010:False:False,False,False
Bears,14,7,10,0,0,31,Eagles,3,10,0,13,0,26,12:2010:False:False,False,False
Ravens,0,17,0,0,0,17,Buccaneers,0,3,0,7,0,10,12:2010:False:False,False,False
Broncos,10,3,0,20,0,33,Rams,7,19,7,3,0,36,12:2010:False:False,False,False
Colts,7,7,0,0,0,14,Chargers,10,6,10,10,0,36,12:2010:False:False,False,False
Cardinals,3,3,0,0,0,6,49ers,14,7,3,3,0,27,12:2010:False:False,False,False
Eagles,7,13,0,14,0,34,Texans,3,7,14,0,0,24,13:2010:False:False,False,False
Vikings,7,24,0,7,0,38,Bills,7,0,0,7,0,14,13:2010:False:False,False,False
Bengals,0,6,6,18,0,30,Saints,3,10,7,14,0,34,13:2010:False:False,False,False
Packers,0,14,14,6,0,34,49ers,3,10,3,0,0,16,13:2010:False:False,False,False
Lions,7,10,3,0,0,20,Bears,7,7,3,7,0,24,13:2010:False:False,False,False
Giants,14,7,7,3,0,31,Redskins,0,0,7,0,0,7,13:2010:False:False,False,False
Chiefs,7,3,0,0,0,10,Broncos,0,3,0,3,0,6,13:2010:False:False,False,False
Titans,0,0,3,3,0,6,Jaguars,7,10,0,0,0,17,13:2010:False:False,False,False
Dolphins,0,3,0,7,0,10,Browns,0,3,7,3,0,13,13:2010:False:False,False,False
Chargers,0,3,3,7,0,13,Raiders,14,7,0,7,0,28,13:2010:False:False,False,False
Seahawks,0,3,21,7,0,31,Panthers,7,7,0,0,0,14,13:2010:False:False,False,False
Cardinals,6,0,0,0,0,6,Rams,3,6,7,3,0,19,13:2010:False:False,False,False
Colts,0,7,7,21,0,35,Cowboys,10,7,10,8,3,38,13:2010:False:False,False,False
Buccaneers,7,7,3,7,0,24,Falcons,7,7,0,14,0,28,13:2010:False:False,False,False
Ravens,7,0,3,0,0,10,Steelers,0,0,3,10,0,13,13:2010:False:False,False,False
Patriots,17,7,7,14,0,45,Jets,0,3,0,0,0,3,13:2010:False:False,False,False
Titans,0,7,7,14,0,28,Colts,7,14,3,6,0,30,14:2010:False:False,False,False
Jaguars,0,7,21,10,0,38,Raiders,7,10,7,7,0,31,14:2010:False:False,False,False
Redskins,0,10,0,6,0,16,Buccaneers,0,3,6,8,0,17,14:2010:False:False,False,False
Lions,0,0,0,7,0,7,Packers,0,0,3,0,0,3,14:2010:False:False,False,False
Steelers,0,10,3,10,0,23,Bengals,7,0,0,0,0,7,14:2010:False:False,False,False
Bills,0,10,0,3,0,13,Browns,3,3,0,0,0,6,14:2010:False:False,False,False
Panthers,0,0,7,3,0,10,Falcons,14,3,7,7,0,31,14:2010:False:False,False,False
Saints,14,7,7,3,0,31,Rams,0,6,0,7,0,13,14:2010:False:False,False,False
49ers,10,20,10,0,0,40,Seahawks,7,0,7,7,0,21,14:2010:False:False,False,False
Jets,0,3,0,3,0,6,Dolphins,10,0,0,0,0,10,14:2010:False:False,False,False
Cardinals,3,13,3,24,0,43,Broncos,3,0,0,10,0,13,14:2010:False:False,False,False
Chargers,7,14,0,10,0,31,Chiefs,0,0,0,0,0,0,14:2010:False:False,False,False
Bears,0,0,7,0,0,7,Patriots,7,26,3,0,0,36,14:2010:False:False,False,False
Cowboys,7,3,10,7,0,27,Eagles,7,7,3,13,0,30,14:2010:False:False,False,False
Vikings,3,0,0,0,0,3,Giants,0,14,7,0,0,21,14:2010:False:False,False,False
Texans,0,7,6,15,0,28,Ravens,7,14,7,0,6,34,14:2010:False:False,False,False
Chargers,7,10,7,10,0,34,49ers,0,0,0,7,0,7,15:2010:False:False,False,False
Rams,6,0,0,7,0,13,Chiefs,0,14,3,10,0,27,15:2010:False:False,False,False
Ravens,7,14,3,6,0,30,Saints,7,7,3,7,0,24,15:2010:False:False,False,False
Buccaneers,0,14,0,6,0,20,Lions,7,3,7,3,3,23,15:2010:False:False,False,False
Panthers,6,7,6,0,0,19,Cardinals,0,3,0,9,0,12,15:2010:False:False,False,False
Giants,7,17,0,7,0,31,Eagles,0,3,7,28,0,38,15:2010:False:False,False,False
Dolphins,0,7,0,7,0,14,Bills,0,10,7,0,0,17,15:2010:False:False,False,False
Bengals,0,10,6,3,0,19,Browns,7,0,0,10,0,17,15:2010:False:False,False,False
Colts,7,7,10,10,0,34,Jaguars,0,10,7,7,0,24,15:2010:False:False,False,False
Titans,21,3,7,0,0,31,Texans,0,3,7,7,0,17,15:2010:False:False,False,False
Cowboys,10,10,10,3,0,33,Redskins,0,7,7,16,0,30,15:2010:False:False,False,False
Seahawks,7,3,0,8,0,18,Falcons,0,17,17,0,0,34,15:2010:False:False,False,False
Raiders,14,3,6,16,0,39,Broncos,14,3,3,3,0,23,15:2010:False:False,False,False
Steelers,0,10,7,0,0,17,Jets,7,3,7,5,0,22,15:2010:False:False,False,False
Patriots,7,7,7,10,0,31,Packers,3,14,7,3,0,27,15:2010:False:False,False,False
Vikings,7,0,7,0,0,14,Bears,10,7,20,3,0,40,15:2010:False:False,False,False
Steelers,3,17,7,0,0,27,Panthers,0,0,0,3,0,3,16:2010:False:False,False,False
Cardinals,14,7,0,6,0,27,Cowboys,0,10,10,6,0,26,16:2010:False:False,False,False
Browns,7,3,0,0,0,10,Ravens,0,13,7,0,0,20,16:2010:False:False,False,False
Chiefs,14,17,3,0,0,34,Titans,0,7,7,0,0,14,16:2010:False:False,False,False
Bills,3,0,0,0,0,3,Patriots,7,17,7,3,0,34,16:2010:False:False,False,False
Bears,10,7,21,0,0,38,Jets,0,24,7,3,0,34,16:2010:False:False,False,False
Rams,9,3,3,10,0,25,49ers,0,14,0,3,0,17,16:2010:False:False,False,False
Jaguars,0,7,3,7,0,17,Redskins,10,0,0,7,3,20,16:2010:False:False,False,False
Dolphins,3,14,7,3,0,27,Lions,3,7,7,17,0,34,16:2010:False:False,False,False
Broncos,0,0,10,14,0,24,Texans,7,10,6,0,0,23,16:2010:False:False,False,False
Raiders,7,6,3,10,0,26,Colts,7,10,7,7,0,31,16:2010:False:False,False,False
Bengals,7,6,0,21,0,34,Chargers,0,3,7,10,0,20,16:2010:False:False,False,False
Packers,14,7,10,14,0,45,Giants,0,14,3,0,0,17,16:2010:False:False,False,False
Buccaneers,3,14,14,7,0,38,Seahawks,7,0,0,8,0,15,16:2010:False:False,False,False
Falcons,0,7,0,7,0,14,Saints,3,7,0,7,0,17,16:2010:False:False,False,False
Eagles,7,0,0,7,0,14,Vikings,0,7,10,7,0,24,16:2010:False:False,False,False
Falcons,14,7,10,0,0,31,Panthers,0,0,3,7,0,10,17:2010:False:False,False,False
Browns,0,3,0,6,0,9,Steelers,14,17,7,3,0,41,17:2010:False:False,False,False
Lions,0,10,3,7,0,20,Vikings,0,0,7,6,0,13,17:2010:False:False,False,False
Ravens,3,3,7,0,0,13,Bengals,0,0,0,7,0,7,17:2010:False:False,False,False
Patriots,14,10,14,0,0,38,Dolphins,0,0,0,7,0,7,17:2010:False:False,False,False
Jets,3,14,7,14,0,38,Bills,0,0,7,0,0,7,17:2010:False:False,False,False
Chiefs,3,0,7,0,0,10,Raiders,0,10,7,14,0,31,17:2010:False:False,False,False
Saints,7,0,3,3,0,13,Buccaneers,3,7,10,3,0,23,17:2010:False:False,False,False
Packers,0,0,3,7,0,10,Bears,0,3,0,0,0,3,17:2010:False:False,False,False
Redskins,0,7,0,7,0,14,Giants,3,7,7,0,0,17,17:2010:False:False,False,False
Colts,3,10,7,3,0,23,Titans,3,3,14,0,0,20,17:2010:False:False,False,False
Texans,10,10,7,7,0,34,Jaguars,0,17,0,0,0,17,17:2010:False:False,False,False
Eagles,0,7,0,6,0,13,Cowboys,0,7,0,7,0,14,17:2010:False:False,False,False
Broncos,7,0,7,14,0,28,Chargers,0,16,10,7,0,33,17:2010:False:False,False,False
49ers,7,3,21,7,0,38,Cardinals,0,7,0,0,0,7,17:2010:False:False,False,False
Seahawks,7,0,3,6,0,16,Rams,0,3,3,0,0,6,17:2010:False:False,False,False
Seahawks,7,17,10,7,0,41,Saints,10,10,0,16,0,36,18:2010:False:True,False,True
Colts,0,7,3,6,0,16,Jets,0,0,7,10,0,17,18:2010:False:True,False,True
Chiefs,7,0,0,0,0,7,Ravens,3,7,13,7,0,30,18:2010:False:True,False,True
Eagles,0,3,7,6,0,16,Packers,7,7,7,0,0,21,18:2010:False:True,False,True
Steelers,7,0,14,10,0,31,Ravens,14,7,0,3,0,24,19:2010:False:True,False,True
Falcons,7,7,0,7,0,21,Packers,0,28,14,6,0,48,19:2010:False:True,False,True
Bears,14,7,7,7,0,35,Seahawks,0,0,3,21,0,24,19:2010:False:True,False,True
Patriots,3,0,8,10,0,21,Jets,0,14,0,14,0,28,19:2010:False:True,False,True
Bears,0,0,0,14,0,14,Packers,7,7,0,7,0,21,20:2010:False:True,False,True
Steelers,7,17,0,0,0,24,Jets,0,3,7,9,0,19,20:2010:False:True,False,True
Packers,14,7,0,10,0,31,Steelers,0,10,7,8,0,25,22:2010:False:True,False,True
Patriots,7,12,14,14,0,47,Jaguars,6,3,0,3,0,12,1:2011:True:False,True,False
Eagles,7,3,3,0,0,13,Ravens,3,0,0,3,0,6,1:2011:True:False,True,False
Chargers,7,3,7,0,0,17,Seahawks,0,0,10,14,0,24,1:2011:True:False,True,False
Cowboys,3,0,7,14,0,24,Broncos,3,6,0,14,0,23,1:2011:True:False,True,False
Raiders,3,3,9,3,0,18,Cardinals,0,7,10,7,0,24,1:2011:True:False,True,False
Falcons,17,0,3,3,0,23,Dolphins,0,14,7,7,0,28,1:2011:True:False,True,False
Lions,14,10,0,10,0,34,Bengals,0,3,0,0,0,3,1:2011:True:False,True,False
Redskins,0,7,3,6,0,16,Steelers,0,7,0,0,0,7,1:2011:True:False,True,False
Chiefs,0,0,0,0,0,0,Buccaneers,10,5,7,3,0,25,1:2011:True:False,True,False
Saints,3,14,0,7,0,24,49ers,0,3,0,0,0,3,1:2011:True:False,True,False
Browns,7,7,10,3,0,27,Packers,7,10,0,0,0,17,1:2011:True:False,True,False
Titans,0,14,0,0,0,14,Vikings,0,0,3,0,0,3,1:2011:True:False,True,False
Rams,10,13,10,0,0,33,Colts,3,0,7,0,0,10,1:2011:True:False,True,False
Bears,0,7,0,3,0,10,Bills,3,0,0,0,0,3,1:2011:True:False,True,False
Panthers,7,6,0,7,0,20,Giants,7,3,0,0,0,10,1:2011:True:False,True,False
Texans,0,13,0,7,0,20,Jets,3,0,10,3,0,16,1:2011:True:False,True,False
Buccaneers,0,0,7,7,0,14,Patriots,21,7,3,0,0,31,2:2011:True:False,True,False
Steelers,7,14,0,3,0,24,Eagles,0,0,0,14,0,14,2:2011:True:False,True,False
Colts,0,0,3,0,0,3,Redskins,10,6,0,0,0,16,2:2011:True:False,True,False
Browns,7,14,7,0,0,28,Lions,10,3,7,10,0,30,2:2011:True:False,True,False
Dolphins,7,10,3,0,0,20,Panthers,0,0,0,10,0,10,2:2011:True:False,True,False
Ravens,3,7,0,21,0,31,Chiefs,3,7,3,0,0,13,2:2011:True:False,True,False
Packers,0,14,0,14,0,28,Cardinals,3,3,14,0,0,20,2:2011:True:False,True,False
Jaguars,0,3,6,6,0,15,Falcons,3,7,3,0,0,13,2:2011:True:False,True,False
Texans,14,10,3,0,0,27,Saints,0,14,0,0,0,14,2:2011:True:False,True,False
Rams,7,0,7,3,0,17,Titans,13,3,0,0,0,16,2:2011:True:False,True,False
49ers,0,3,7,7,0,17,Raiders,0,0,0,3,0,3,2:2011:True:False,True,False
Broncos,0,14,10,0,0,24,Bills,3,0,0,7,0,10,2:2011:True:False,True,False
Seahawks,0,0,0,7,0,7,Vikings,7,6,0,7,0,20,2:2011:True:False,True,False
Jets,10,7,3,7,0,27,Bengals,0,7,0,0,0,7,2:2011:True:False,True,False
Cowboys,0,7,0,0,0,7,Chargers,3,14,0,3,0,20,2:2011:True:False,True,False
Giants,3,17,7,14,0,41,Bears,3,3,0,7,0,13,2:2011:True:False,True,False
Bengals,0,24,0,0,0,24,Panthers,7,0,6,0,0,13,3:2011:True:False,True,False
Eagles,7,10,7,0,0,24,Browns,0,0,0,14,0,14,3:2011:True:False,True,False
Ravens,0,14,7,13,0,34,Redskins,14,7,7,3,0,31,3:2011:True:False,True,False
Chiefs,0,3,7,0,0,10,Rams,14,0,0,0,0,14,3:2011:True:False,True,False
Colts,0,14,0,7,0,21,Packers,7,3,3,11,0,24,3:2011:True:False,True,False
Bills,3,14,0,15,3,35,Jaguars,0,10,14,8,0,32,3:2011:True:False,True,False
Buccaneers,0,10,0,7,0,17,Dolphins,7,3,0,3,0,13,3:2011:True:False,True,False
Steelers,10,14,0,10,0,34,Falcons,3,13,0,0,0,16,3:2011:True:False,True,False
Titans,0,7,7,0,0,14,Bears,7,3,0,3,0,13,3:2011:True:False,True,False
Lions,10,17,0,7,0,34,Patriots,0,10,0,0,0,10,3:2011:True:False,True,False
49ers,7,0,0,0,0,7,Texans,10,14,3,3,0,30,3:2011:True:False,True,False
Vikings,7,3,7,0,0,17,Cowboys,3,14,3,3,0,23,3:2011:True:False,True,False
Broncos,0,10,7,6,0,23,Seahawks,3,0,0,17,0,20,3:2011:True:False,True,False
Cardinals,17,7,0,7,0,31,Chargers,3,14,3,14,0,34,3:2011:True:False,True,False
Raiders,7,3,10,0,0,20,Saints,14,3,15,8,0,40,3:2011:True:False,True,False
Giants,0,3,0,0,0,3,Jets,0,7,0,10,0,17,3:2011:True:False,True,False
Bills,0,0,0,6,0,6,Lions,7,3,3,3,0,16,4:2011:True:False,True,False
Bengals,0,10,0,3,0,13,Colts,3,0,0,14,0,17,4:2011:True:False,True,False
Jets,0,7,0,7,0,14,Eagles,7,7,7,3,0,24,4:2011:True:False,True,False
Patriots,10,7,0,0,0,17,Giants,3,0,0,15,0,18,4:2011:True:False,True,False
Dolphins,7,0,7,3,0,17,Cowboys,0,3,0,0,0,3,4:2011:True:False,True,False
Falcons,0,0,7,0,0,7,Ravens,0,3,7,11,0,21,4:2011:True:False,True,False
Jaguars,0,7,3,7,0,17,Rams,7,0,7,10,0,24,4:2011:True:False,True,False
Redskins,7,10,3,9,0,29,Buccaneers,0,3,10,11,0,24,4:2011:True:False,True,False
Bears,10,7,0,7,0,24,Browns,0,7,0,7,0,14,4:2011:True:False,True,False
Vikings,0,7,7,14,0,28,Texans,0,0,0,0,0,0,4:2011:True:False,True,False
Saints,0,0,0,9,0,9,Titans,5,17,3,7,0,32,4:2011:True:False,True,False
Panthers,7,7,3,0,0,17,Steelers,7,13,3,10,0,33,4:2011:True:False,True,False
Packers,7,0,13,0,0,20,Chiefs,2,14,0,3,0,19,4:2011:True:False,True,False
Cardinals,14,6,3,3,0,26,Broncos,0,0,0,7,0,7,4:2011:True:False,True,False
Chargers,0,7,3,7,0,17,49ers,14,0,3,3,0,20,4:2011:True:False,True,False
Seahawks,3,7,0,10,0,20,Raiders,0,3,0,0,0,3,4:2011:True:False,True,False
Packers,21,7,7,7,0,42,Saints,7,10,10,7,0,34,1:2011:False:False,False,False
Jaguars,7,3,3,3,0,16,Titans,0,0,7,7,0,14,1:2011:False:False,False,False
Chiefs,0,7,0,0,0,7,Bills,14,6,14,7,0,41,1:2011:False:False,False,False
Bears,10,6,14,0,0,30,Falcons,3,0,3,6,0,12,1:2011:False:False,False,False
Buccaneers,10,3,0,7,0,20,Lions,6,14,7,0,0,27,1:2011:False:False,False,False
Rams,7,3,3,0,0,13,Eagles,14,3,7,7,0,31,1:2011:False:False,False,False
Texans,17,17,0,0,0,34,Colts,0,0,0,7,0,7,1:2011:False:False,False,False
Browns,0,14,3,0,0,17,Bengals,10,3,0,14,0,27,1:2011:False:False,False,False
Ravens,14,7,11,3,0,35,Steelers,0,7,0,0,0,7,1:2011:False:False,False,False
Cardinals,7,0,7,14,0,28,Panthers,7,7,7,0,0,21,1:2011:False:False,False,False
49ers,0,16,0,17,0,33,Seahawks,0,0,7,10,0,17,1:2011:False:False,False,False
Chargers,7,0,7,10,0,24,Vikings,7,10,0,0,0,17,1:2011:False:False,False,False
Redskins,0,14,7,7,0,28,Giants,7,7,0,0,0,14,1:2011:False:False,False,False
Jets,0,7,3,17,0,27,Cowboys,7,3,7,7,0,24,1:2011:False:False,False,False
Dolphins,7,0,10,7,0,24,Patriots,7,7,14,10,0,38,1:2011:False:False,False,False
Broncos,3,0,10,7,0,20,Raiders,0,16,0,7,0,23,1:2011:False:False,False,False
Titans,0,10,10,6,0,26,Ravens,0,10,0,3,0,13,2:2011:False:False,False,False
Jets,9,6,14,3,0,32,Jaguars,3,0,0,0,0,3,2:2011:False:False,False,False
Colts,3,6,3,7,0,19,Browns,0,14,0,13,0,27,2:2011:False:False,False,False
Redskins,0,10,0,12,0,22,Cardinals,7,0,7,7,0,21,2:2011:False:False,False,False
Vikings,7,10,0,3,0,20,Buccaneers,0,0,10,14,0,24,2:2011:False:False,False,False
Panthers,10,3,0,10,0,23,Packers,0,7,16,7,0,30,2:2011:False:False,False,False
Saints,3,13,7,7,0,30,Bears,7,3,3,0,0,13,2:2011:False:False,False,False
Steelers,7,10,7,0,0,24,Seahawks,0,0,0,0,0,0,2:2011:False:False,False,False
Lions,7,13,7,21,0,48,Chiefs,3,0,0,0,0,3,2:2011:False:False,False,False
Bills,0,3,14,21,0,38,Raiders,0,21,0,14,0,35,2:2011:False:False,False,False
49ers,0,14,7,3,0,24,Cowboys,0,7,7,10,3,27,2:2011:False:False,False,False
Patriots,7,13,0,15,0,35,Chargers,7,0,0,14,0,21,2:2011:False:False,False,False
Broncos,7,3,7,7,0,24,Bengals,0,3,12,7,0,22,2:2011:False:False,False,False
Dolphins,3,0,7,3,0,13,Texans,6,10,0,7,0,23,2:2011:False:False,False,False
Falcons,7,7,7,14,0,35,Eagles,0,10,21,0,0,31,2:2011:False:False,False,False
Giants,7,14,7,0,0,28,Rams,6,0,10,0,0,16,2:2011:False:False,False,False
Bills,0,10,7,17,0,34,Patriots,14,7,3,7,0,31,3:2011:False:False,False,False
Browns,0,7,3,7,0,17,Dolphins,7,3,3,3,0,16,3:2011:False:False,False,False
Titans,0,10,0,7,0,17,Broncos,7,0,7,0,0,14,3:2011:False:False,False,False
Eagles,0,13,3,0,0,16,Giants,14,0,0,15,0,29,3:2011:False:False,False,False
Vikings,6,14,0,3,0,23,Lions,0,0,10,13,3,26,3:2011:False:False,False,False
Bengals,3,0,0,5,0,8,49ers,0,0,3,10,0,13,3:2011:False:False,False,False
Panthers,2,3,3,8,0,16,Jaguars,0,10,0,0,0,10,3:2011:False:False,False,False
Saints,0,10,7,23,0,40,Texans,10,6,3,14,0,33,3:2011:False:False,False,False
Chargers,0,10,7,3,0,20,Chiefs,0,0,7,10,0,17,3:2011:False:False,False,False
Rams,0,0,7,0,0,7,Ravens,21,6,3,7,0,37,3:2011:False:False,False,False
Raiders,7,10,7,10,0,34,Jets,7,10,0,7,0,24,3:2011:False:False,False,False
Bears,0,10,0,7,0,17,Packers,7,10,3,7,0,27,3:2011:False:False,False,False
Seahawks,3,3,7,0,0,13,Cardinals,0,10,0,0,0,10,3:2011:False:False,False,False
Buccaneers,3,10,3,0,0,16,Falcons,0,3,0,10,0,13,3:2011:False:False,False,False
Colts,0,13,0,7,0,20,Steelers,10,0,0,13,0,23,3:2011:False:False,False,False
Cowboys,3,6,3,6,0,18,Redskins,6,3,7,0,0,16,3:2011:False:False,False,False
Texans,7,3,0,7,0,17,Steelers,0,0,7,3,0,10,4:2011:False:False,False,False
Cowboys,7,13,10,0,0,30,Lions,0,3,14,17,0,34,4:2011:False:False,False,False
Eagles,7,13,3,0,0,23,49ers,0,3,14,7,0,24,4:2011:False:False,False,False
Bears,10,14,0,10,0,34,Panthers,3,17,0,9,0,29,4:2011:False:False,False,False
Rams,0,0,0,10,0,10,Redskins,7,7,3,0,0,17,4:2011:False:False,False,False
Jaguars,0,10,0,0,0,10,Saints,7,7,6,3,0,23,4:2011:False:False,False,False
Chiefs,3,6,6,7,0,22,Vikings,7,0,3,7,0,17,4:2011:False:False,False,False
Bengals,3,0,10,10,0,23,Bills,0,17,0,3,0,20,4:2011:False:False,False,False
Browns,3,3,0,7,0,13,Titans,7,14,10,0,0,31,4:2011:False:False,False,False
Seahawks,0,7,14,7,0,28,Falcons,7,17,3,3,0,30,4:2011:False:False,False,False
Cardinals,3,3,14,7,0,27,Giants,0,10,0,21,0,31,4:2011:False:False,False,False
Packers,14,14,14,7,0,49,Broncos,3,14,0,6,0,23,4:2011:False:False,False,False
Raiders,3,7,3,6,0,19,Patriots,7,10,7,7,0,31,4:2011:False:False,False,False
Chargers,7,6,10,3,0,26,Dolphins,7,3,3,3,0,16,4:2011:False:False,False,False
Ravens,17,10,7,0,0,34,Jets,7,10,0,0,0,17,4:2011:False:False,False,False
Buccaneers,0,7,10,7,0,24,Colts,3,7,7,0,0,17,4:2011:False:False,False,False
Texans,7,7,3,3,0,20,Raiders,3,9,3,10,0,25,5:2011:False:False,False,False
Colts,7,17,0,0,0,24,Chiefs,0,14,7,7,0,28,5:2011:False:False,False,False
Jaguars,7,6,0,7,0,20,Bengals,7,6,0,17,0,30,5:2011:False:False,False,False
Giants,7,7,0,11,0,25,Seahawks,14,0,2,20,0,36,5:2011:False:False,False,False
Vikings,28,0,3,3,0,34,Cardinals,0,3,7,0,0,10,5:2011:False:False,False,False
Bills,7,14,10,0,0,31,Eagles,0,7,7,10,0,24,5:2011:False:False,False,False
Steelers,7,14,7,10,0,38,Titans,3,0,7,7,0,17,5:2011:False:False,False,False
Panthers,6,7,7,7,0,27,Saints,10,10,3,7,0,30,5:2011:False:False,False,False
49ers,7,17,10,14,0,48,Buccaneers,3,0,0,0,0,3,5:2011:False:False,False,False
Patriots,7,3,14,6,0,30,Jets,0,7,7,7,0,21,5:2011:False:False,False,False
Broncos,7,3,0,14,0,24,Chargers,6,17,0,6,0,29,5:2011:False:False,False,False
Falcons,7,7,0,0,0,14,Packers,0,6,9,10,0,25,5:2011:False:False,False,False
Lions,0,7,14,3,0,24,Bears,0,10,0,3,0,13,5:2011:False:False,False,False
Bengals,7,3,10,7,0,27,Colts,0,7,0,10,0,17,6:2011:False:False,False,False
Steelers,7,10,0,0,0,17,Jaguars,0,3,7,3,0,13,6:2011:False:False,False,False
Redskins,0,3,3,7,0,13,Eagles,7,13,0,0,0,20,6:2011:False:False,False,False
Lions,10,0,3,6,0,19,49ers,0,12,3,10,0,25,6:2011:False:False,False,False
Packers,3,21,0,0,0,24,Rams,0,3,0,0,0,3,6:2011:False:False,False,False
Giants,7,10,7,3,0,27,Bills,14,3,0,7,0,24,6:2011:False:False,False,False
Falcons,7,7,0,17,0,31,Panthers,3,7,7,0,0,17,6:2011:False:False,False,False
Ravens,7,3,6,13,0,29,Texans,0,7,7,0,0,14,6:2011:False:False,False,False
Raiders,7,7,10,0,0,24,Browns,0,7,0,10,0,17,6:2011:False:False,False,False
Buccaneers,3,17,3,3,0,26,Saints,7,3,3,7,0,20,6:2011:False:False,False,False
Patriots,3,10,0,7,0,20,Cowboys,3,7,3,3,0,16,6:2011:False:False,False,False
Bears,16,10,10,3,0,39,Vikings,0,3,7,0,0,10,6:2011:False:False,False,False
Jets,7,7,3,7,0,24,Dolphins,3,3,0,0,0,6,6:2011:False:False,False,False
Jets,3,7,7,10,0,27,Chargers,7,14,0,0,0,21,7:2011:False:False,False,False
Titans,0,0,7,0,0,7,Texans,3,17,7,14,0,41,7:2011:False:False,False,False
Lions,3,3,10,0,0,16,Falcons,10,7,3,3,0,23,7:2011:False:False,False,False
Panthers,3,6,14,10,0,33,Redskins,0,6,7,7,0,20,7:2011:False:False,False,False
Buccaneers,2,3,0,13,0,18,Bears,7,7,7,3,0,24,7:2011:False:False,False,False
Dolphins,0,6,0,9,0,15,Broncos,0,0,0,15,3,18,7:2011:False:False,False,False
Browns,0,3,0,3,0,6,Seahawks,0,0,3,0,0,3,7:2011:False:False,False,False
Raiders,0,0,0,0,0,0,Chiefs,14,0,7,7,0,28,7:2011:False:False,False,False
Cardinals,0,7,7,6,0,20,Steelers,7,10,9,6,0,32,7:2011:False:False,False,False
Vikings,7,10,0,10,0,27,Packers,7,6,20,0,0,33,7:2011:False:False,False,False
Cowboys,7,10,3,14,0,34,Rams,0,7,0,0,0,7,7:2011:False:False,False,False
Saints,21,13,14,14,0,62,Colts,0,7,0,0,0,7,7:2011:False:False,False,False
Jaguars,3,3,3,3,0,12,Ravens,0,0,0,7,0,7,7:2011:False:False,False,False
Giants,3,7,0,10,0,20,Dolphins,7,7,3,0,0,17,8:2011:False:False,False,False
Texans,7,0,7,10,0,24,Jaguars,0,7,0,7,0,14,8:2011:False:False,False,False
Titans,3,17,0,7,0,27,Colts,0,0,3,7,0,10,8:2011:False:False,False,False
Panthers,0,14,7,0,0,21,Vikings,7,7,7,3,0,24,8:2011:False:False,False,False
Rams,0,17,7,7,0,31,Saints,0,0,7,14,0,21,8:2011:False:False,False,False
Ravens,0,6,14,10,0,30,Cardinals,3,21,0,3,0,27,8:2011:False:False,False,False
Bills,7,6,7,3,0,23,Redskins,0,0,0,0,0,0,8:2011:False:False,False,False
Broncos,3,0,0,7,0,10,Lions,7,17,14,7,0,45,8:2011:False:False,False,False
49ers,10,7,0,3,0,20,Browns,0,3,0,7,0,10,8:2011:False:False,False,False
Seahawks,0,3,3,6,0,12,Bengals,10,7,0,17,0,34,8:2011:False:False,False,False
Steelers,7,10,3,5,0,25,Patriots,0,10,0,7,0,17,8:2011:False:False,False,False
Eagles,14,10,3,7,0,34,Cowboys,0,0,0,7,0,7,8:2011:False:False,False,False
Chiefs,10,3,0,7,3,23,Chargers,0,3,9,8,0,20,8:2011:False:False,False,False
Texans,14,10,3,3,0,30,Browns,3,0,3,6,0,12,9:2011:False:False,False,False
Chiefs,3,0,0,0,0,3,Dolphins,7,7,14,3,0,31,9:2011:False:False,False,False
Cowboys,3,3,7,10,0,23,Seahawks,3,3,0,7,0,13,9:2011:False:False,False,False
Redskins,0,3,0,8,0,11,49ers,0,13,3,3,0,19,9:2011:False:False,False,False
Saints,7,10,7,3,0,27,Buccaneers,0,3,3,10,0,16,9:2011:False:False,False,False
Bills,0,0,3,8,0,11,Jets,0,3,17,7,0,27,9:2011:False:False,False,False
Colts,0,7,0,0,0,7,Falcons,14,7,7,3,0,31,9:2011:False:False,False,False
Titans,3,14,0,0,0,17,Bengals,0,7,7,10,0,24,9:2011:False:False,False,False
Raiders,3,14,7,0,0,24,Broncos,7,0,17,14,0,38,9:2011:False:False,False,False
Patriots,0,0,3,17,0,20,Giants,0,0,10,14,0,24,9:2011:False:False,False,False
Chargers,7,10,7,14,0,38,Packers,21,7,3,14,0,45,9:2011:False:False,False,False
Cardinals,3,0,3,7,6,19,Rams,3,6,4,0,0,13,9:2011:False:False,False,False
Steelers,0,6,0,14,0,20,Ravens,3,6,7,7,0,23,9:2011:False:False,False,False
Eagles,0,10,14,0,0,24,Bears,7,10,3,10,0,30,9:2011:False:False,False,False
Chargers,3,0,14,0,0,17,Raiders,7,10,7,0,0,24,10:2011:False:False,False,False
Cowboys,14,14,6,10,0,44,Bills,0,7,0,0,0,7,10:2011:False:False,False,False
Browns,3,6,3,0,0,12,Rams,0,10,0,3,0,13,10:2011:False:False,False,False
Dolphins,7,3,3,7,0,20,Redskins,3,3,3,0,0,9,10:2011:False:False,False,False
Falcons,3,3,7,10,0,23,Saints,3,7,7,6,3,26,10:2011:False:False,False,False
Eagles,0,14,0,3,0,17,Cardinals,0,7,0,14,0,21,10:2011:False:False,False,False
Panthers,0,0,3,0,0,3,Titans,14,3,3,10,0,30,10:2011:False:False,False,False
Buccaneers,0,3,0,6,0,9,Texans,9,7,14,7,0,37,10:2011:False:False,False,False
Bengals,7,3,7,0,0,17,Steelers,14,3,7,0,0,24,10:2011:False:False,False,False
Colts,0,3,0,0,0,3,Jaguars,3,0,7,7,0,17,10:2011:False:False,False,False
Chiefs,0,0,7,3,0,10,Broncos,7,3,0,7,0,17,10:2011:False:False,False,False
Seahawks,10,9,3,0,0,22,Ravens,0,7,3,7,0,17,10:2011:False:False,False,False
Bears,10,10,17,0,0,37,Lions,0,6,0,7,0,13,10:2011:False:False,False,False
49ers,3,6,3,15,0,27,Giants,3,3,7,7,0,20,10:2011:False:False,False,False
Jets,0,9,0,7,0,16,Patriots,6,7,10,14,0,37,10:2011:False:False,False,False
Packers,14,3,14,14,0,45,Vikings,0,0,7,0,0,7,10:2011:False:False,False,False
Broncos,3,0,7,7,0,17,Jets,0,3,7,3,0,13,11:2011:False:False,False,False
Vikings,7,0,0,14,0,21,Raiders,3,21,3,0,0,27,11:2011:False:False,False,False
Redskins,0,14,3,7,0,24,Cowboys,7,3,0,14,3,27,11:2011:False:False,False,False
Packers,7,14,0,14,0,35,Buccaneers,0,10,3,13,0,26,11:2011:False:False,False,False
Lions,0,14,14,21,0,49,Panthers,10,17,0,8,0,35,11:2011:False:False,False,False
Ravens,0,14,10,7,0,31,Bengals,7,0,7,10,0,24,11:2011:False:False,False,False
Browns,0,7,0,7,0,14,Jaguars,0,7,0,3,0,10,11:2011:False:False,False,False
Dolphins,14,14,7,0,0,35,Bills,3,3,0,2,0,8,11:2011:False:False,False,False
Rams,7,0,0,0,0,7,Seahawks,0,10,7,7,0,24,11:2011:False:False,False,False
49ers,6,3,14,0,0,23,Cardinals,0,0,0,7,0,7,11:2011:False:False,False,False
Bears,3,14,14,0,0,31,Chargers,3,7,7,3,0,20,11:2011:False:False,False,False
Falcons,7,6,10,0,0,23,Titans,0,3,7,7,0,17,11:2011:False:False,False,False
Giants,0,3,0,7,0,10,Eagles,0,10,0,7,0,17,11:2011:False:False,False,False
Patriots,0,10,17,7,0,34,Chiefs,3,0,0,0,0,3,11:2011:False:False,False,False
Lions,0,0,0,15,0,15,Packers,0,7,17,3,0,27,12:2011:False:False,False,False
Cowboys,0,10,0,10,0,20,Dolphins,3,3,10,3,0,19,12:2011:False:False,False,False
Ravens,3,3,0,10,0,16,49ers,3,0,3,0,0,6,12:2011:False:False,False,False
Jaguars,7,3,0,3,0,13,Texans,7,13,0,0,0,20,12:2011:False:False,False,False
Titans,7,3,0,13,0,23,Buccaneers,3,7,7,0,0,17,12:2011:False:False,False,False
Colts,0,10,3,6,0,19,Panthers,3,7,7,10,0,27,12:2011:False:False,False,False
Rams,7,3,0,10,0,20,Cardinals,3,0,17,3,0,23,12:2011:False:False,False,False
Jets,0,14,7,7,0,28,Bills,7,7,7,3,0,24,12:2011:False:False,False,False
Bengals,7,0,10,6,0,23,Browns,7,10,3,0,0,20,12:2011:False:False,False,False
Falcons,7,10,0,7,0,24,Vikings,0,0,7,7,0,14,12:2011:False:False,False,False
Seahawks,0,7,3,7,0,17,Redskins,7,0,0,16,0,23,12:2011:False:False,False,False
Raiders,6,6,6,7,0,25,Bears,0,7,0,13,0,20,12:2011:False:False,False,False
Eagles,10,3,0,7,0,20,Patriots,7,17,7,7,0,38,12:2011:False:False,False,False
Chargers,3,7,3,0,0,13,Broncos,0,7,3,3,3,16,12:2011:False:False,False,False
Chiefs,3,3,0,3,0,9,Steelers,0,13,0,0,0,13,12:2011:False:False,False,False
Saints,0,21,14,14,0,49,Giants,0,3,7,14,0,24,12:2011:False:False,False,False
Seahawks,7,10,7,7,0,31,Eagles,0,7,0,7,0,14,13:2011:False:False,False,False
Redskins,7,6,0,6,0,19,Jets,7,3,3,21,0,34,13:2011:False:False,False,False
Patriots,3,14,14,0,0,31,Colts,0,3,0,21,0,24,13:2011:False:False,False,False
Vikings,5,10,7,10,0,32,Broncos,7,0,14,14,0,35,13:2011:False:False,False,False
Texans,3,7,0,7,0,17,Falcons,0,3,7,0,0,10,13:2011:False:False,False,False
Buccaneers,3,9,0,7,0,19,Panthers,14,10,7,7,0,38,13:2011:False:False,False,False
Steelers,0,28,7,0,0,35,Bengals,0,7,0,0,0,7,13:2011:False:False,False,False
Bears,0,3,0,0,0,3,Chiefs,0,7,3,0,0,10,13:2011:False:False,False,False
Bills,7,3,0,7,0,17,Titans,10,7,3,3,0,23,13:2011:False:False,False,False
Dolphins,6,7,21,0,0,34,Raiders,0,0,0,14,0,14,13:2011:False:False,False,False
Browns,0,0,3,7,0,10,Ravens,0,10,7,7,0,24,13:2011:False:False,False,False
49ers,3,6,10,7,0,26,Rams,0,0,0,0,0,0,13:2011:False:False,False,False
Cardinals,3,0,3,7,6,19,Cowboys,0,10,3,0,0,13,13:2011:False:False,False,False
Giants,10,7,7,11,0,35,Packers,7,14,7,10,0,38,13:2011:False:False,False,False
Saints,3,21,0,7,0,31,Lions,0,7,10,0,0,17,13:2011:False:False,False,False
Jaguars,0,14,0,0,0,14,Chargers,10,14,7,7,0,38,13:2011:False:False,False,False
Steelers,7,0,0,7,0,14,Browns,3,0,0,0,0,3,14:2011:False:False,False,False
Redskins,10,10,7,0,0,27,Patriots,14,6,14,0,0,34,14:2011:False:False,False,False
Titans,0,3,7,7,0,17,Saints,3,3,3,13,0,22,14:2011:False:False,False,False
Jaguars,0,28,0,13,0,41,Buccaneers,7,7,0,0,0,14,14:2011:False:False,False,False
Dolphins,7,0,3,0,0,10,Eagles,0,24,0,2,0,26,14:2011:False:False,False,False
Panthers,7,16,0,0,0,23,Falcons,7,0,10,14,0,31,14:2011:False:False,False,False
Lions,21,10,0,3,0,34,Vikings,7,7,7,7,0,28,14:2011:False:False,False,False
Jets,7,21,7,2,0,37,Chiefs,3,0,0,7,0,10,14:2011:False:False,False,False
Bengals,6,10,3,0,0,19,Texans,3,0,7,10,0,20,14:2011:False:False,False,False
Ravens,10,7,7,0,0,24,Colts,0,3,0,7,0,10,14:2011:False:False,False,False
Broncos,0,0,0,10,3,13,Bears,0,0,7,3,0,10,14:2011:False:False,False,False
Cardinals,0,7,7,7,0,21,49ers,3,9,7,0,0,19,14:2011:False:False,False,False
Chargers,7,9,14,7,0,37,Bills,0,0,10,0,0,10,14:2011:False:False,False,False
Packers,14,17,12,3,0,46,Raiders,0,0,7,9,0,16,14:2011:False:False,False,False
Cowboys,7,10,3,14,0,34,Giants,5,10,7,15,0,37,14:2011:False:False,False,False
Seahawks,10,0,10,10,0,30,Rams,0,3,3,7,0,13,14:2011:False:False,False,False
Falcons,10,17,14,0,0,41,Jaguars,0,0,7,7,0,14,15:2011:False:False,False,False
Buccaneers,0,0,15,0,0,15,Cowboys,14,14,3,0,0,31,15:2011:False:False,False,False
Bears,7,7,0,0,0,14,Seahawks,7,0,17,14,0,38,15:2011:False:False,False,False
Chiefs,6,0,3,10,0,19,Packers,0,0,7,7,0,14,15:2011:False:False,False,False
Texans,0,0,6,7,0,13,Panthers,7,14,0,7,0,28,15:2011:False:False,False,False
Vikings,3,10,0,7,0,20,Saints,7,14,14,7,0,42,15:2011:False:False,False,False
Rams,0,6,0,7,0,13,Bengals,3,0,10,7,0,20,15:2011:False:False,False,False
Bills,7,0,0,16,0,23,Dolphins,0,13,7,10,0,30,15:2011:False:False,False,False
Colts,3,0,14,10,0,27,Titans,0,6,0,7,0,13,15:2011:False:False,False,False
Giants,0,3,0,7,0,10,Redskins,3,14,3,3,0,23,15:2011:False:False,False,False
Raiders,7,10,0,10,0,27,Lions,7,7,0,14,0,28,15:2011:False:False,False,False
Eagles,14,14,10,7,0,45,Jets,0,13,0,6,0,19,15:2011:False:False,False,False
Cardinals,0,7,0,10,3,20,Browns,7,3,7,0,0,17,15:2011:False:False,False,False
Broncos,13,3,0,7,0,23,Patriots,7,20,7,7,0,41,15:2011:False:False,False,False
Chargers,7,10,14,3,0,34,Ravens,0,7,0,7,0,14,15:2011:False:False,False,False
49ers,3,3,7,7,0,20,Steelers,0,0,3,0,0,3,15:2011:False:False,False,False
Colts,3,3,3,10,0,19,Texans,10,0,3,3,0,16,16:2011:False:False,False,False
Titans,10,7,3,3,0,23,Jaguars,7,3,0,7,0,17,16:2011:False:False,False,False
Chiefs,3,0,3,7,0,13,Raiders,3,0,7,3,3,16,16:2011:False:False,False,False
Jets,7,0,0,7,0,14,Giants,0,10,7,12,0,29,16:2011:False:False,False,False
Redskins,0,10,10,6,0,26,Vikings,3,7,13,10,0,33,16:2011:False:False,False,False
Panthers,10,10,21,7,0,48,Buccaneers,0,10,0,6,0,16,16:2011:False:False,False,False
Bengals,10,10,3,0,0,23,Cardinals,0,0,0,16,0,16,16:2011:False:False,False,False
Steelers,3,7,3,14,0,27,Rams,0,0,0,0,0,0,16:2011:False:False,False,False
Ravens,10,7,3,0,0,20,Browns,0,0,7,7,0,14,16:2011:False:False,False,False
Patriots,0,0,17,10,0,27,Dolphins,3,14,0,7,0,24,16:2011:False:False,False,False
Bills,0,17,6,17,0,40,Broncos,7,0,7,0,0,14,16:2011:False:False,False,False
Lions,10,14,7,7,0,38,Chargers,0,0,10,0,0,10,16:2011:False:False,False,False
Cowboys,0,0,0,7,0,7,Eagles,7,7,3,3,0,20,16:2011:False:False,False,False
Seahawks,7,3,0,7,0,17,49ers,0,3,10,6,0,19,16:2011:False:False,False,False
Packers,7,7,14,7,0,35,Bears,0,3,7,11,0,21,16:2011:False:False,False,False
Saints,7,14,10,14,0,45,Falcons,10,0,3,3,0,16,16:2011:False:False,False,False
Dolphins,3,3,0,13,0,19,Jets,7,3,0,7,0,17,17:2011:False:False,False,False
Patriots,0,14,14,21,0,49,Bills,21,0,0,0,0,21,17:2011:False:False,False,False
Rams,7,0,3,17,0,27,49ers,7,13,7,7,0,34,17:2011:False:False,False,False
Saints,14,10,14,7,0,45,Panthers,7,10,0,0,0,17,17:2011:False:False,False,False
Vikings,10,3,0,0,0,13,Bears,0,14,0,3,0,17,17:2011:False:False,False,False
Packers,10,14,7,14,0,45,Lions,9,10,15,7,0,41,17:2011:False:False,False,False
Eagles,3,7,3,21,0,34,Redskins,0,0,7,3,0,10,17:2011:False:False,False,False
Jaguars,7,3,6,3,0,19,Colts,0,3,3,7,0,13,17:2011:False:False,False,False
Texans,7,3,3,9,0,22,Titans,0,13,3,7,0,23,17:2011:False:False,False,False
Falcons,21,21,0,3,0,45,Buccaneers,0,7,11,6,0,24,17:2011:False:False,False,False
Raiders,7,6,6,7,0,26,Chargers,7,17,7,7,0,38,17:2011:False:False,False,False
Broncos,0,0,3,0,0,3,Chiefs,7,0,0,0,0,7,17:2011:False:False,False,False
Browns,0,6,3,0,0,9,Steelers,0,3,10,0,0,13,17:2011:False:False,False,False
Bengals,3,0,7,6,0,16,Ravens,10,7,0,7,0,24,17:2011:False:False,False,False
Cardinals,7,3,7,3,3,23,Seahawks,0,3,7,10,0,20,17:2011:False:False,False,False
Giants,7,14,0,10,0,31,Cowboys,0,0,7,7,0,14,17:2011:False:False,False,False
Texans,7,10,7,7,0,31,Bengals,7,3,0,0,0,10,18:2011:False:True,False,True
Saints,0,10,14,21,0,45,Lions,7,7,7,7,0,28,18:2011:False:True,False,True
Giants,0,7,10,7,0,24,Falcons,0,2,0,0,0,2,18:2011:False:True,False,True
Broncos,0,20,0,3,6,29,Steelers,6,0,7,10,0,23,18:2011:False:True,False,True
49ers,14,3,3,16,0,36,Saints,0,14,0,18,0,32,19:2011:False:True,False,True
Patriots,14,21,7,3,0,45,Broncos,0,7,3,0,0,10,19:2011:False:True,False,True
Ravens,17,0,0,3,0,20,Texans,3,10,0,0,0,13,19:2011:False:True,False,True
Packers,3,7,3,7,0,20,Giants,10,10,0,17,0,37,19:2011:False:True,False,True
Patriots,3,10,3,7,0,23,Ravens,0,10,10,0,0,20,20:2011:False:True,False,True
49ers,7,0,7,3,0,17,Giants,0,10,0,7,3,20,20:2011:False:True,False,True
Patriots,0,10,7,0,0,17,Giants,9,0,6,6,0,21,22:2011:False:True,False,True
Bills,3,0,0,3,0,6,Redskins,7,0,0,0,0,7,1:2012:True:False,True,False
Falcons,7,10,0,0,0,17,Ravens,0,7,17,7,0,31,1:2012:True:False,True,False
Eagles,0,0,14,10,0,24,Steelers,3,10,7,3,0,23,1:2012:True:False,True,False
Patriots,0,0,7,0,0,7,Saints,3,0,0,3,0,6,1:2012:True:False,True,False
Chargers,7,7,0,7,0,21,Packers,0,7,0,6,0,13,1:2012:True:False,True,False
Bears,0,0,0,3,0,3,Broncos,3,7,14,7,0,31,1:2012:True:False,True,False
Lions,7,7,0,3,0,17,Browns,0,3,7,9,0,19,1:2012:True:False,True,False
Jaguars,7,7,7,11,0,32,Giants,10,14,0,7,0,31,1:2012:True:False,True,False
Dolphins,0,0,7,0,0,7,Buccaneers,7,7,3,3,0,20,1:2012:True:False,True,False
Bengals,0,10,7,0,0,17,Jets,0,3,0,3,0,6,1:2012:True:False,True,False
Chiefs,14,3,3,7,0,27,Cardinals,0,3,7,7,0,17,1:2012:True:False,True,False
49ers,7,10,0,0,0,17,Vikings,3,3,0,0,0,6,1:2012:True:False,True,False
Panthers,3,10,0,0,0,13,Texans,10,3,10,3,0,26,1:2012:True:False,True,False
Seahawks,10,0,7,10,0,27,Titans,0,3,14,0,0,17,1:2012:True:False,True,False
Colts,7,14,7,10,0,38,Rams,0,3,0,0,0,3,1:2012:True:False,True,False
Raiders,0,0,0,0,0,0,Cowboys,0,0,3,0,0,3,1:2012:True:False,True,False
Falcons,0,13,0,6,0,19,Bengals,3,7,7,7,0,24,2:2012:True:False,True,False
Packers,7,0,0,3,0,10,Browns,6,10,14,5,0,35,2:2012:True:False,True,False
Buccaneers,7,0,0,0,0,7,Titans,7,13,3,7,0,30,2:2012:True:False,True,False
Vikings,10,6,3,17,0,36,Bills,0,7,7,0,0,14,2:2012:True:False,True,False
Panthers,17,3,0,3,0,23,Dolphins,0,7,3,7,0,17,2:2012:True:False,True,False
Ravens,3,6,0,3,0,12,Lions,0,17,0,10,0,27,2:2012:True:False,True,False
Saints,3,7,7,7,0,24,Jaguars,7,10,3,7,0,27,2:2012:True:False,True,False
Cardinals,7,17,0,7,0,31,Raiders,8,3,13,3,0,27,2:2012:True:False,True,False
Jets,0,0,3,0,0,3,Giants,3,10,3,10,0,26,2:2012:True:False,True,False
Rams,14,3,7,7,0,31,Chiefs,0,10,0,7,0,17,2:2012:True:False,True,False
Texans,3,7,3,7,0,20,49ers,3,3,3,0,0,9,2:2012:True:False,True,False
Bears,14,6,10,3,0,33,Redskins,0,10,0,21,0,31,2:2012:True:False,True,False
Broncos,7,3,0,0,0,10,Seahawks,3,6,7,14,0,30,2:2012:True:False,True,False
Chargers,0,0,7,21,0,28,Cowboys,3,7,3,7,0,20,2:2012:True:False,True,False
Steelers,14,0,6,6,0,26,Colts,0,17,7,0,0,24,2:2012:True:False,True,False
Patriots,3,11,3,0,0,17,Eagles,0,14,10,3,0,27,2:2012:True:False,True,False
Bengals,3,3,7,0,0,13,Packers,14,3,0,10,0,27,3:2012:True:False,True,False
Ravens,3,10,14,21,0,48,Jaguars,0,3,0,14,0,17,3:2012:True:False,True,False
Titans,7,10,6,9,0,32,Cardinals,3,7,3,14,0,27,3:2012:True:False,True,False
Buccaneers,14,6,3,7,0,30,Patriots,0,7,7,14,0,28,3:2012:True:False,True,False
Browns,0,3,0,7,0,10,Eagles,14,3,7,3,0,27,3:2012:True:False,True,False
Dolphins,0,3,3,0,0,6,Falcons,3,6,7,7,0,23,3:2012:True:False,True,False
Chiefs,0,7,0,7,0,14,Seahawks,6,17,21,0,0,44,3:2012:True:False,True,False
Giants,3,14,0,0,0,17,Bears,7,0,6,7,0,20,3:2012:True:False,True,False
Vikings,0,3,0,7,0,10,Chargers,3,3,0,6,0,12,3:2012:True:False,True,False
Redskins,0,14,9,7,0,30,Colts,0,7,0,10,0,17,3:2012:True:False,True,False
Raiders,0,10,7,14,0,31,Lions,3,3,7,7,0,20,3:2012:True:False,True,False
Bills,7,0,0,0,0,7,Steelers,0,14,7,17,0,38,3:2012:True:False,True,False
Cowboys,17,3,0,0,0,20,Rams,3,3,0,13,0,19,3:2012:True:False,True,False
Saints,14,10,3,7,0,34,Texans,14,10,0,3,0,27,3:2012:True:False,True,False
Broncos,17,7,0,0,0,24,49ers,7,3,10,9,0,29,3:2012:True:False,True,False
Jets,3,6,3,0,0,12,Panthers,3,7,0,7,0,17,3:2012:True:False,True,False
Giants,0,0,3,3,0,6,Patriots,0,3,0,0,0,3,4:2012:True:False,True,False
Redskins,6,10,14,0,0,30,Buccaneers,0,0,3,0,0,3,4:2012:True:False,True,False
Cowboys,0,20,7,3,0,30,Dolphins,6,0,7,0,0,13,4:2012:True:False,True,False
Jaguars,0,7,7,10,0,24,Falcons,7,0,7,0,0,14,4:2012:True:False,True,False
Eagles,0,14,0,14,0,28,Jets,0,10,0,0,0,10,4:2012:True:False,True,False
Steelers,10,0,0,7,0,17,Panthers,0,3,7,6,0,16,4:2012:True:False,True,False
Rams,14,7,7,3,0,31,Ravens,0,0,10,7,0,17,4:2012:True:False,True,False
Titans,3,0,7,0,0,10,Saints,3,3,0,0,0,6,4:2012:True:False,True,False
Lions,28,0,0,10,0,38,Bills,7,3,14,8,0,32,4:2012:True:False,True,False
Packers,0,14,7,3,0,24,Chiefs,3,0,0,0,0,3,4:2012:True:False,True,False
Texans,7,7,14,0,0,28,Vikings,0,10,14,0,0,24,4:2012:True:False,True,False
Colts,0,14,0,6,0,20,Bengals,3,10,3,0,0,16,4:2012:True:False,True,False
Browns,0,7,3,10,0,20,Bears,7,7,14,0,0,28,4:2012:True:False,True,False
49ers,14,7,14,0,0,35,Chargers,0,0,0,3,0,3,4:2012:True:False,True,False
Seahawks,3,10,6,2,0,21,Raiders,0,0,0,3,0,3,4:2012:True:False,True,False
Cardinals,0,7,3,3,0,13,Broncos,0,0,7,9,0,16,4:2012:True:False,True,False
Giants,0,3,7,7,0,17,Cowboys,0,7,10,7,0,24,1:2012:False:False,False,False
Texans,0,24,3,3,0,30,Dolphins,3,0,7,0,0,10,1:2012:False:False,False,False
Titans,3,0,7,3,0,13,Patriots,7,14,7,6,0,34,1:2012:False:False,False,False
Lions,0,10,3,14,0,27,Rams,3,10,0,10,0,23,1:2012:False:False,False,False
Saints,7,7,3,15,0,32,Redskins,10,10,10,10,0,40,1:2012:False:False,False,False
Browns,3,0,3,10,0,16,Eagles,0,10,0,7,0,17,1:2012:False:False,False,False
Chiefs,3,14,0,7,0,24,Falcons,10,10,14,6,0,40,1:2012:False:False,False,False
Jets,7,20,14,7,0,48,Bills,0,7,7,14,0,28,1:2012:False:False,False,False
Vikings,0,7,7,9,3,26,Jaguars,3,6,3,11,0,23,1:2012:False:False,False,False
Bears,7,17,10,7,0,41,Colts,7,7,0,7,0,21,1:2012:False:False,False,False
Cardinals,3,7,3,7,0,20,Seahawks,3,0,10,3,0,16,1:2012:False:False,False,False
Buccaneers,10,3,0,3,0,16,Panthers,0,0,7,3,0,10,1:2012:False:False,False,False
Packers,0,7,0,15,0,22,49ers,3,13,7,7,0,30,1:2012:False:False,False,False
Broncos,0,7,7,17,0,31,Steelers,0,10,3,6,0,19,1:2012:False:False,False,False
Ravens,10,7,17,10,0,44,Bengals,0,10,3,0,0,13,1:2012:False:False,False,False
Raiders,3,3,0,8,0,14,Chargers,3,7,6,6,0,22,1:2012:False:False,False,False
Packers,0,13,0,10,0,23,Bears,0,0,3,7,0,10,2:2012:False:False,False,False
Giants,6,7,3,25,0,41,Buccaneers,3,21,3,7,0,34,2:2012:False:False,False,False
Dolphins,7,0,14,14,0,35,Raiders,7,3,0,3,0,13,2:2012:False:False,False,False
Jaguars,0,0,7,0,0,7,Texans,10,7,7,3,0,27,2:2012:False:False,False,False
Bengals,7,10,7,10,0,34,Browns,3,7,7,10,0,27,2:2012:False:False,False,False
Bills,7,14,14,0,0,35,Chiefs,0,0,3,14,0,17,2:2012:False:False,False,False
Eagles,7,0,10,7,0,24,Ravens,7,10,0,6,0,23,2:2012:False:False,False,False
Panthers,7,14,7,7,0,35,Saints,10,3,0,14,0,27,2:2012:False:False,False,False
Patriots,3,3,3,9,0,18,Cardinals,6,0,7,7,0,20,2:2012:False:False,False,False
Colts,7,10,3,3,0,23,Vikings,3,3,0,14,0,20,2:2012:False:False,False,False
Rams,3,13,7,8,0,31,Redskins,14,7,7,0,0,28,2:2012:False:False,False,False
Seahawks,10,3,7,7,0,27,Cowboys,0,7,0,0,0,7,2:2012:False:False,False,False
Steelers,3,10,7,7,0,27,Jets,7,3,0,0,0,10,2:2012:False:False,False,False
Chargers,14,3,7,14,0,38,Titans,0,3,7,0,0,10,2:2012:False:False,False,False
49ers,7,7,3,10,0,27,Lions,6,0,3,10,0,19,2:2012:False:False,False,False
Falcons,10,10,7,0,0,27,Broncos,0,7,0,14,0,21,2:2012:False:False,False,False
Panthers,0,0,7,0,0,7,Giants,10,10,6,10,0,36,3:2012:False:False,False,False
Cowboys,7,3,0,6,0,16,Buccaneers,7,0,0,3,0,10,3:2012:False:False,False,False
Colts,7,7,0,3,0,17,Jaguars,3,0,10,9,0,22,3:2012:False:False,False,False
Browns,0,7,7,0,0,14,Bills,14,0,3,7,0,24,3:2012:False:False,False,False
Dolphins,7,3,7,3,0,20,Jets,0,3,7,10,3,23,3:2012:False:False,False,False
Saints,7,3,14,0,0,24,Chiefs,3,3,7,11,3,27,3:2012:False:False,False,False
Redskins,7,3,14,7,0,31,Bengals,14,10,0,14,0,38,3:2012:False:False,False,False
Bears,3,7,0,13,0,23,Rams,0,3,3,0,0,6,3:2012:False:False,False,False
Vikings,7,10,0,7,0,24,49ers,0,3,10,0,0,13,3:2012:False:False,False,False
Titans,10,10,0,21,3,44,Lions,6,3,7,25,0,41,3:2012:False:False,False,False
Chargers,0,0,3,0,0,3,Falcons,6,14,0,7,0,27,3:2012:False:False,False,False
Cardinals,10,14,0,3,0,27,Eagles,0,0,6,0,0,6,3:2012:False:False,False,False
Raiders,7,7,7,13,0,34,Steelers,14,3,14,0,0,31,3:2012:False:False,False,False
Broncos,5,6,0,14,0,25,Texans,7,14,10,0,0,31,3:2012:False:False,False,False
Ravens,0,14,7,10,0,31,Patriots,13,7,7,3,0,30,3:2012:False:False,False,False
Seahawks,0,7,0,7,0,14,Packers,0,0,6,6,0,12,3:2012:False:False,False,False
Ravens,0,9,14,0,0,23,Browns,0,7,3,6,0,16,4:2012:False:False,False,False
Bills,0,14,7,7,0,28,Patriots,7,0,14,31,0,52,4:2012:False:False,False,False
Jets,0,0,0,0,0,0,49ers,0,10,7,17,0,34,4:2012:False:False,False,False
Rams,3,10,3,3,0,19,Seahawks,7,0,3,3,0,13,4:2012:False:False,False,False
Falcons,7,10,7,6,0,30,Panthers,7,7,7,7,0,28,4:2012:False:False,False,False
Lions,3,3,0,7,0,13,Vikings,10,3,7,0,0,20,4:2012:False:False,False,False
Chiefs,0,6,7,7,0,20,Chargers,17,10,0,10,0,37,4:2012:False:False,False,False
Texans,14,0,14,10,0,38,Titans,0,7,0,7,0,14,4:2012:False:False,False,False
Jaguars,0,7,3,0,0,10,Bengals,3,14,0,10,0,27,4:2012:False:False,False,False
Broncos,10,0,21,6,0,37,Raiders,3,3,0,0,0,6,4:2012:False:False,False,False
Cardinals,0,0,7,14,3,24,Dolphins,0,13,0,8,0,21,4:2012:False:False,False,False
Buccaneers,3,3,7,9,0,22,Redskins,7,14,0,3,0,24,4:2012:False:False,False,False
Packers,7,14,0,7,0,28,Saints,7,7,10,3,0,27,4:2012:False:False,False,False
Eagles,0,7,6,6,0,19,Giants,0,3,7,7,0,17,4:2012:False:False,False,False
Cowboys,0,7,3,8,0,18,Bears,0,10,14,10,0,34,4:2012:False:False,False,False
Rams,7,3,0,7,0,17,Cardinals,3,0,0,0,0,3,5:2012:False:False,False,False
Steelers,0,10,0,6,0,16,Eagles,0,0,7,7,0,14,5:2012:False:False,False,False
Colts,0,3,16,11,0,30,Packers,7,14,0,6,0,27,5:2012:False:False,False,False
Giants,7,20,7,7,0,41,Browns,14,3,3,7,0,27,5:2012:False:False,False,False
Redskins,0,7,3,7,0,17,Falcons,0,7,0,17,0,24,5:2012:False:False,False,False
Bengals,6,0,0,7,0,13,Dolphins,0,7,10,0,0,17,5:2012:False:False,False,False
Chiefs,0,3,0,3,0,6,Ravens,3,0,6,0,0,9,5:2012:False:False,False,False
Panthers,0,3,7,2,0,12,Seahawks,3,3,7,3,0,16,5:2012:False:False,False,False
Jaguars,0,3,0,0,0,3,Bears,3,0,10,28,0,41,5:2012:False:False,False,False
Patriots,7,10,14,0,0,31,Broncos,0,7,7,7,0,21,5:2012:False:False,False,False
49ers,3,14,7,21,0,45,Bills,0,3,0,0,0,3,5:2012:False:False,False,False
Vikings,7,6,10,7,0,30,Titans,0,0,0,7,0,7,5:2012:False:False,False,False
Saints,7,7,7,10,0,31,Chargers,7,10,7,0,0,24,5:2012:False:False,False,False
Jets,7,0,7,3,0,17,Texans,7,10,6,0,0,23,5:2012:False:False,False,False
Titans,6,10,0,10,0,26,Steelers,10,0,3,10,0,23,6:2012:False:False,False,False
Buccaneers,7,0,14,17,0,38,Chiefs,0,3,0,7,0,10,6:2012:False:False,False,False
Jets,0,21,7,7,0,35,Colts,3,3,0,3,0,9,6:2012:False:False,False,False
Browns,0,7,6,21,0,34,Bengals,7,7,0,10,0,24,6:2012:False:False,False,False
Eagles,0,7,6,10,0,23,Lions,6,0,0,17,3,26,6:2012:False:False,False,False
Falcons,0,7,6,10,0,23,Raiders,3,10,0,7,0,20,6:2012:False:False,False,False
Dolphins,0,10,7,0,0,17,Rams,6,0,0,8,0,14,6:2012:False:False,False,False
Ravens,3,14,7,7,0,31,Cowboys,7,3,10,9,0,29,6:2012:False:False,False,False
Cardinals,3,7,3,3,0,16,Bills,9,0,7,0,3,19,6:2012:False:False,False,False
Seahawks,10,0,0,14,0,24,Patriots,7,10,3,3,0,23,6:2012:False:False,False,False
49ers,3,0,0,0,0,3,Giants,0,10,13,3,0,26,6:2012:False:False,False,False
Redskins,0,17,7,14,0,38,Vikings,9,0,3,14,0,26,6:2012:False:False,False,False
Texans,0,10,7,7,0,24,Packers,14,7,7,14,0,42,6:2012:False:False,False,False
Chargers,10,14,0,0,0,24,Broncos,0,0,14,21,0,35,6:2012:False:False,False,False
49ers,3,0,7,3,0,13,Seahawks,3,3,0,0,0,6,7:2012:False:False,False,False
Vikings,7,7,7,0,0,21,Cardinals,0,7,0,7,0,14,7:2012:False:False,False,False
Panthers,0,7,0,7,0,14,Cowboys,0,3,10,6,0,19,7:2012:False:False,False,False
Buccaneers,14,7,0,7,0,28,Saints,7,21,0,7,0,35,7:2012:False:False,False,False
Rams,3,3,0,14,0,20,Packers,10,0,7,13,0,30,7:2012:False:False,False,False
Giants,0,13,0,14,0,27,Redskins,3,10,0,10,0,23,7:2012:False:False,False,False
Texans,9,20,7,7,0,43,Ravens,3,0,7,3,0,13,7:2012:False:False,False,False
Bills,14,6,14,0,0,34,Titans,14,7,7,7,0,35,7:2012:False:False,False,False
Colts,7,7,3,0,0,17,Browns,0,6,7,0,0,13,7:2012:False:False,False,False
Patriots,14,2,7,3,3,29,Jets,7,3,3,13,0,26,7:2012:False:False,False,False
Raiders,3,3,7,10,3,26,Jaguars,7,10,3,3,0,23,7:2012:False:False,False,False
Bengals,7,7,3,0,0,17,Steelers,3,11,3,7,0,24,7:2012:False:False,False,False
Bears,10,0,3,0,0,13,Lions,0,0,0,7,0,7,7:2012:False:False,False,False
Vikings,0,10,7,0,0,17,Buccaneers,10,10,10,6,0,36,8:2012:False:False,False,False
Jets,0,0,3,6,0,9,Dolphins,10,10,7,3,0,30,8:2012:False:False,False,False
Browns,7,0,0,0,0,7,Chargers,0,3,3,0,0,6,8:2012:False:False,False,False
Titans,3,7,0,3,0,13,Colts,3,0,3,7,6,19,8:2012:False:False,False,False
Rams,7,0,0,0,0,7,Patriots,7,21,10,7,0,45,8:2012:False:False,False,False
Packers,7,7,0,10,0,24,Jaguars,3,9,0,3,0,15,8:2012:False:False,False,False
Eagles,0,7,3,7,0,17,Falcons,14,10,3,3,0,30,8:2012:False:False,False,False
Steelers,10,10,7,0,0,27,Redskins,0,6,3,3,0,12,8:2012:False:False,False,False
Lions,7,7,0,14,0,28,Seahawks,3,14,0,7,0,24,8:2012:False:False,False,False
Bears,7,0,0,16,0,23,Panthers,3,10,6,3,0,22,8:2012:False:False,False,False
Chiefs,0,6,3,7,0,16,Raiders,3,10,10,3,0,26,8:2012:False:False,False,False
Cowboys,0,10,14,0,0,24,Giants,13,10,0,6,0,29,8:2012:False:False,False,False
Broncos,7,10,7,10,0,34,Saints,0,7,0,7,0,14,8:2012:False:False,False,False
Cardinals,0,0,3,0,0,3,49ers,7,10,7,0,0,24,8:2012:False:False,False,False
Chargers,7,3,0,21,0,31,Chiefs,0,3,3,7,0,13,9:2012:False:False,False,False
Packers,7,14,10,0,0,31,Cardinals,0,7,10,0,0,17,9:2012:False:False,False,False
Jaguars,0,0,0,14,0,14,Lions,0,21,0,10,0,31,9:2012:False:False,False,False
Titans,2,3,7,8,0,20,Bears,28,3,6,14,0,51,9:2012:False:False,False,False
Bengals,0,3,10,10,0,23,Broncos,3,7,7,14,0,31,9:2012:False:False,False,False
Redskins,3,0,3,7,0,13,Panthers,7,7,0,7,0,21,9:2012:False:False,False,False
Browns,0,9,3,3,0,15,Ravens,14,0,0,11,0,25,9:2012:False:False,False,False
Colts,7,6,7,3,0,23,Dolphins,3,14,0,3,0,20,9:2012:False:False,False,False
Texans,7,0,7,7,0,21,Bills,0,6,3,0,0,9,9:2012:False:False,False,False
Seahawks,14,6,7,3,0,30,Vikings,7,10,3,0,0,20,9:2012:False:False,False,False
Raiders,3,7,0,22,0,32,Buccaneers,0,7,21,14,0,42,9:2012:False:False,False,False
Giants,0,14,6,0,0,20,Steelers,0,10,0,14,0,24,9:2012:False:False,False,False
Falcons,0,6,0,13,0,19,Cowboys,6,0,0,7,0,13,9:2012:False:False,False,False
Saints,7,14,7,0,0,28,Eagles,0,3,10,0,0,13,9:2012:False:False,False,False
Jaguars,0,3,0,7,0,10,Colts,3,14,7,3,0,27,10:2012:False:False,False,False
Buccaneers,7,10,7,10,0,34,Chargers,14,7,0,3,0,24,10:2012:False:False,False,False
Dolphins,0,3,0,0,0,3,Titans,14,10,7,6,0,37,10:2012:False:False,False,False
Patriots,10,14,7,6,0,37,Bills,0,17,7,7,0,31,10:2012:False:False,False,False
Ravens,10,17,21,7,0,55,Raiders,0,10,7,3,0,20,10:2012:False:False,False,False
Panthers,7,0,0,7,0,14,Broncos,7,10,7,12,0,36,10:2012:False:False,False,False
Bengals,14,3,14,0,0,31,Giants,3,3,0,7,0,13,10:2012:False:False,False,False
Vikings,10,3,3,18,0,34,Lions,0,3,7,14,0,24,10:2012:False:False,False,False
Saints,7,14,7,3,0,31,Falcons,10,7,0,10,0,27,10:2012:False:False,False,False
Seahawks,7,7,0,14,0,28,Jets,7,0,0,0,0,7,10:2012:False:False,False,False
Eagles,7,0,10,6,0,23,Cowboys,7,3,7,21,0,38,10:2012:False:False,False,False
49ers,0,7,0,17,0,24,Rams,14,0,3,7,0,24,10:2012:False:False,False,False
Bears,0,3,3,0,0,6,Texans,3,7,0,3,0,13,10:2012:False:False,False,False
Steelers,0,10,0,3,3,16,Chiefs,7,3,0,3,0,13,10:2012:False:False,False,False
Bills,13,6,0,0,0,19,Dolphins,7,0,0,7,0,14,11:2012:False:False,False,False
Lions,3,7,7,3,0,20,Packers,0,7,7,10,0,24,11:2012:False:False,False,False
Falcons,0,16,0,7,0,23,Cardinals,13,3,0,3,0,19,11:2012:False:False,False,False
Panthers,7,7,0,7,0,21,Buccaneers,10,0,0,11,6,27,11:2012:False:False,False,False
Cowboys,0,0,3,17,3,23,Browns,7,6,0,7,0,20,11:2012:False:False,False,False
Redskins,7,10,7,7,0,31,Eagles,0,3,3,0,0,6,11:2012:False:False,False,False
Rams,7,0,0,6,0,13,Jets,3,10,0,14,0,27,11:2012:False:False,False,False
Chiefs,3,3,0,0,0,6,Bengals,7,14,0,7,0,28,11:2012:False:False,False,False
Texans,7,10,3,14,9,43,Jaguars,7,10,10,7,3,37,11:2012:False:False,False,False
Raiders,0,7,3,7,0,17,Saints,14,7,14,3,0,38,11:2012:False:False,False,False
Broncos,0,17,7,6,0,30,Chargers,7,0,9,7,0,23,11:2012:False:False,False,False
Patriots,7,17,14,21,0,59,Colts,14,3,0,7,0,24,11:2012:False:False,False,False
Steelers,7,0,3,0,0,10,Ravens,10,0,3,0,0,13,11:2012:False:False,False,False
49ers,10,10,7,5,0,32,Bears,0,0,7,0,0,7,11:2012:False:False,False,False
Lions,7,14,3,7,0,31,Texans,0,14,10,7,3,34,12:2012:False:False,False,False
Cowboys,3,0,10,18,0,31,Redskins,0,28,0,10,0,38,12:2012:False:False,False,False
Jets,0,3,9,7,0,19,Patriots,0,35,0,14,0,49,12:2012:False:False,False,False
Colts,7,6,7,0,0,20,Bills,3,3,0,7,0,13,12:2012:False:False,False,False
Dolphins,0,7,0,17,0,24,Seahawks,0,7,7,7,0,21,12:2012:False:False,False,False
Buccaneers,7,3,3,10,0,23,Falcons,3,7,7,7,0,24,12:2012:False:False,False,False
Bengals,14,10,0,10,0,34,Raiders,0,0,10,0,0,10,12:2012:False:False,False,False
Browns,3,10,7,0,0,20,Steelers,7,7,0,0,0,14,12:2012:False:False,False,False
Jaguars,7,0,7,10,0,24,Titans,3,3,3,10,0,19,12:2012:False:False,False,False
Chiefs,6,0,3,0,0,9,Broncos,0,7,7,3,0,17,12:2012:False:False,False,False
Bears,10,15,3,0,0,28,Vikings,3,0,7,0,0,10,12:2012:False:False,False,False
Chargers,0,10,0,3,0,13,Ravens,0,0,3,10,3,16,12:2012:False:False,False,False
Saints,7,7,7,0,0,21,49ers,7,7,14,3,0,31,12:2012:False:False,False,False
Cardinals,7,10,0,0,0,17,Rams,0,14,14,3,0,31,12:2012:False:False,False,False
Giants,17,14,7,0,0,38,Packers,7,3,0,0,0,10,12:2012:False:False,False,False
Eagles,3,12,7,0,0,22,Panthers,14,0,7,9,0,30,12:2012:False:False,False,False
Falcons,7,10,0,6,0,23,Saints,0,7,6,0,0,13,13:2012:False:False,False,False
Bears,7,0,7,3,0,17,Seahawks,0,10,0,7,6,23,13:2012:False:False,False,False
Titans,3,0,7,0,0,10,Texans,14,7,3,0,0,24,13:2012:False:False,False,False
Dolphins,3,7,0,6,0,16,Patriots,7,10,0,6,0,23,13:2012:False:False,False,False
Bills,7,10,10,7,0,34,Jaguars,0,10,0,8,0,18,13:2012:False:False,False,False
Lions,10,13,7,3,0,33,Colts,7,7,7,14,0,35,13:2012:False:False,False,False
Chiefs,10,7,7,3,0,27,Panthers,7,7,0,7,0,21,13:2012:False:False,False,False
Packers,10,0,10,3,0,23,Vikings,0,14,0,0,0,14,13:2012:False:False,False,False
Rams,0,0,2,11,3,16,49ers,7,0,0,6,0,13,13:2012:False:False,False,False
Jets,0,0,0,7,0,7,Cardinals,0,3,0,3,0,6,13:2012:False:False,False,False
Broncos,7,0,21,3,0,31,Buccaneers,10,0,0,13,0,23,13:2012:False:False,False,False
Ravens,0,13,7,0,0,20,Steelers,3,3,7,10,0,23,13:2012:False:False,False,False
Chargers,0,13,0,0,0,13,Bengals,7,3,0,10,0,20,13:2012:False:False,False,False
Raiders,0,3,7,7,0,17,Browns,0,10,3,7,0,20,13:2012:False:False,False,False
Cowboys,0,10,7,21,0,38,Eagles,7,10,7,9,0,33,13:2012:False:False,False,False
Redskins,7,3,0,7,0,17,Giants,3,10,3,0,0,16,13:2012:False:False,False,False
Raiders,0,7,0,6,0,13,Broncos,10,3,13,0,0,26,14:2012:False:False,False,False
Redskins,14,0,6,8,3,31,Ravens,7,14,0,7,0,28,14:2012:False:False,False,False
Bengals,10,3,6,0,0,19,Cowboys,3,7,0,10,0,20,14:2012:False:False,False,False
Bills,3,3,6,0,0,12,Rams,0,0,7,8,0,15,14:2012:False:False,False,False
Buccaneers,0,0,7,14,0,21,Eagles,0,10,0,13,0,23,14:2012:False:False,False,False
Panthers,7,9,7,7,0,30,Falcons,0,0,7,13,0,20,14:2012:False:False,False,False
Browns,3,7,10,10,0,30,Chiefs,7,0,0,0,0,7,14:2012:False:False,False,False
Steelers,0,3,7,14,0,24,Chargers,3,10,14,7,0,34,14:2012:False:False,False,False
Colts,7,0,14,6,0,27,Titans,7,13,0,3,0,23,14:2012:False:False,False,False
Jaguars,0,3,0,7,0,10,Jets,0,0,10,7,0,17,14:2012:False:False,False,False
Vikings,14,0,7,0,0,21,Bears,0,7,0,7,0,14,14:2012:False:False,False,False
49ers,0,6,7,14,0,27,Dolphins,0,3,3,7,0,13,14:2012:False:False,False,False
Seahawks,10,28,13,7,0,58,Cardinals,0,0,0,0,0,0,14:2012:False:False,False,False
Giants,14,7,14,17,0,52,Saints,7,6,14,0,0,27,14:2012:False:False,False,False
Packers,0,10,7,10,0,27,Lions,7,7,3,3,0,20,14:2012:False:False,False,False
Patriots,14,7,7,14,0,42,Texans,0,0,7,7,0,14,14:2012:False:False,False,False
Eagles,0,13,0,0,0,13,Bengals,10,0,14,10,0,34,15:2012:False:False,False,False
Bears,0,7,3,3,0,13,Packers,0,14,7,0,0,21,15:2012:False:False,False,False
Texans,10,10,3,6,0,29,Colts,0,10,7,0,0,17,15:2012:False:False,False,False
Ravens,0,0,3,14,0,17,Broncos,3,14,14,3,0,34,15:2012:False:False,False,False
Dolphins,3,7,6,8,0,24,Jaguars,3,0,0,0,0,3,15:2012:False:False,False,False
Browns,7,7,0,7,0,21,Redskins,7,3,14,14,0,38,15:2012:False:False,False,False
Rams,0,7,0,15,0,22,Vikings,7,23,3,3,0,36,15:2012:False:False,False,False
Saints,7,17,7,10,0,41,Buccaneers,0,0,0,0,0,0,15:2012:False:False,False,False
Falcons,14,3,10,7,0,34,Giants,0,0,0,0,0,0,15:2012:False:False,False,False
Bills,7,10,0,0,0,17,Seahawks,14,17,16,3,0,50,15:2012:False:False,False,False
Chargers,0,0,0,7,0,7,Panthers,21,3,7,0,0,31,15:2012:False:False,False,False
Cardinals,0,21,3,14,0,38,Lions,0,7,3,0,0,10,15:2012:False:False,False,False
Raiders,3,6,3,3,0,15,Chiefs,0,0,0,0,0,0,15:2012:False:False,False,False
Cowboys,3,7,7,7,3,27,Steelers,0,10,7,7,0,24,15:2012:False:False,False,False
Patriots,0,3,7,24,0,34,49ers,7,10,14,10,0,41,15:2012:False:False,False,False
Titans,0,7,7,0,0,14,Jets,3,0,7,0,0,10,15:2012:False:False,False,False
Lions,3,3,7,5,0,18,Falcons,7,14,0,10,0,31,16:2012:False:False,False,False
Packers,14,6,14,21,0,55,Titans,0,0,0,7,0,7,16:2012:False:False,False,False
Texans,3,0,3,0,0,6,Vikings,7,6,3,7,0,23,16:2012:False:False,False,False
Buccaneers,3,3,7,0,0,13,Rams,0,14,14,0,0,28,16:2012:False:False,False,False
Eagles,7,3,3,7,0,20,Redskins,0,13,14,0,0,27,16:2012:False:False,False,False
Cowboys,0,14,3,14,0,31,Saints,7,10,7,7,3,34,16:2012:False:False,False,False
Jets,14,0,0,3,0,17,Chargers,7,3,14,3,0,27,16:2012:False:False,False,False
Panthers,7,7,0,3,0,17,Raiders,0,3,0,3,0,6,16:2012:False:False,False,False
Dolphins,7,7,10,0,0,24,Bills,0,3,0,7,0,10,16:2012:False:False,False,False
Steelers,0,7,3,0,0,10,Bengals,7,3,0,3,0,13,16:2012:False:False,False,False
Jaguars,10,3,0,3,0,16,Patriots,3,10,3,7,0,23,16:2012:False:False,False,False
Chiefs,3,0,10,0,0,13,Colts,7,6,0,7,0,20,16:2012:False:False,False,False
Broncos,7,7,7,13,0,34,Browns,3,0,3,6,0,12,16:2012:False:False,False,False
Ravens,14,10,3,6,0,33,Giants,7,0,0,7,0,14,16:2012:False:False,False,False
Cardinals,3,3,0,7,0,13,Bears,7,14,7,0,0,28,16:2012:False:False,False,False
Seahawks,14,14,7,7,0,42,49ers,0,6,0,7,0,13,16:2012:False:False,False,False
Falcons,3,0,7,7,0,17,Buccaneers,3,10,9,0,0,22,17:2012:False:False,False,False
Bills,7,7,0,14,0,28,Jets,3,6,0,0,0,9,17:2012:False:False,False,False
Bengals,0,7,6,10,0,23,Ravens,7,0,0,10,0,17,17:2012:False:False,False,False
Steelers,0,10,7,7,0,24,Browns,0,3,7,0,0,10,17:2012:False:False,False,False
Lions,3,7,7,7,0,24,Bears,10,10,3,3,0,26,17:2012:False:False,False,False
Titans,7,14,14,3,0,38,Jaguars,7,7,0,6,0,20,17:2012:False:False,False,False
Giants,21,14,0,7,0,42,Eagles,0,7,0,0,0,7,17:2012:False:False,False,False
Saints,0,17,7,14,0,38,Panthers,3,10,14,17,0,44,17:2012:False:False,False,False
Colts,7,7,7,7,0,28,Texans,3,3,10,0,0,16,17:2012:False:False,False,False
Vikings,10,10,7,10,0,37,Packers,0,10,14,10,0,34,17:2012:False:False,False,False
Seahawks,0,3,10,7,0,20,Rams,0,7,3,3,0,13,17:2012:False:False,False,False
Patriots,7,14,0,7,0,28,Dolphins,0,0,0,0,0,0,17:2012:False:False,False,False
Broncos,7,14,14,3,0,38,Chiefs,0,3,0,0,0,3,17:2012:False:False,False,False
Chargers,10,7,7,0,0,24,Raiders,0,7,0,14,0,21,17:2012:False:False,False,False
49ers,0,7,10,10,0,27,Cardinals,3,3,0,7,0,13,17:2012:False:False,False,False
Redskins,0,7,7,14,0,28,Cowboys,0,7,0,11,0,18,17:2012:False:False,False,False
Texans,3,6,7,3,0,19,Bengals,0,7,3,3,0,13,18:2012:False:True,False,True
Packers,7,10,7,0,0,24,Vikings,3,0,0,7,0,10,18:2012:False:True,False,True
Ravens,0,10,7,7,0,24,Colts,0,6,3,0,0,9,18:2012:False:True,False,True
Redskins,14,0,0,0,0,14,Seahawks,0,13,0,11,0,24,18:2012:False:True,False,True
Broncos,14,7,7,7,0,35,Ravens,14,7,7,7,3,38,19:2012:False:True,False,True
49ers,7,17,7,14,0,45,Packers,14,7,3,7,0,31,19:2012:False:True,False,True
Falcons,10,10,7,3,0,30,Seahawks,0,0,7,21,0,28,19:2012:False:True,False,True
Patriots,7,10,14,10,0,41,Texans,3,10,0,15,0,28,19:2012:False:True,False,True
Falcons,10,14,0,0,0,24,49ers,0,14,7,7,0,28,20:2012:False:True,False,True
Patriots,3,10,0,0,0,13,Ravens,0,7,7,14,0,28,20:2012:False:True,False,True
49ers,3,3,17,8,0,31,Ravens,7,14,7,6,0,34,22:2012:False:True,False,True
Buccaneers,3,10,3,0,0,16,Ravens,0,24,7,13,0,44,1:2013:True:False,True,False
Falcons,3,0,7,0,0,10,Bengals,0,17,10,7,0,34,1:2013:True:False,True,False
Browns,3,17,0,7,0,27,Rams,0,10,3,6,0,19,1:2013:True:False,True,False
Titans,14,0,0,7,0,21,Redskins,7,7,0,8,0,22,1:2013:True:False,True,False
49ers,3,0,0,3,0,6,Broncos,0,7,0,3,0,10,1:2013:True:False,True,False
Chargers,3,0,0,7,0,10,Seahawks,0,7,10,14,0,31,1:2013:True:False,True,False
Lions,10,10,3,3,0,26,Jets,7,0,10,0,0,17,1:2013:True:False,True,False
Eagles,7,7,0,8,0,22,Patriots,14,10,7,0,0,31,1:2013:True:False,True,False
Jaguars,0,3,0,0,0,3,Dolphins,7,7,3,10,0,27,1:2013:True:False,True,False
Panthers,7,7,7,3,0,24,Bears,7,3,0,7,0,17,1:2013:True:False,True,False
Vikings,3,10,0,0,0,13,Texans,3,7,3,14,0,27,1:2013:True:False,True,False
Saints,0,3,14,0,0,17,Chiefs,10,0,0,3,0,13,1:2013:True:False,True,False
Packers,0,0,0,0,0,0,Cardinals,7,7,0,3,0,17,1:2013:True:False,True,False
Raiders,3,3,10,3,0,19,Cowboys,3,7,0,7,0,17,1:2013:True:False,True,False
Steelers,3,3,0,7,0,13,Giants,10,3,2,3,0,18,1:2013:True:False,True,False
Colts,10,3,0,7,0,20,Bills,3,17,10,14,0,44,1:2013:True:False,True,False
Eagles,7,7,0,0,0,14,Panthers,0,6,3,0,0,9,2:2013:True:False,True,False
Browns,10,7,0,7,0,24,Lions,0,3,3,0,0,6,2:2013:True:False,True,False
Ravens,7,0,0,20,0,27,Falcons,10,10,3,0,0,23,2:2013:True:False,True,False
Bears,14,6,7,6,0,33,Chargers,0,7,14,7,0,28,2:2013:True:False,True,False
Bills,0,13,7,0,0,20,Vikings,3,0,0,13,0,16,2:2013:True:False,True,False
Patriots,8,10,7,0,0,25,Buccaneers,0,10,0,11,0,21,2:2013:True:False,True,False
Saints,17,6,0,5,0,28,Raiders,0,7,10,3,0,20,2:2013:True:False,True,False
Chiefs,10,3,0,0,0,13,49ers,3,3,3,6,0,15,2:2013:True:False,True,False
Cardinals,3,6,0,3,0,12,Cowboys,0,0,0,7,0,7,2:2013:True:False,True,False
Bengals,7,10,0,10,0,27,Titans,3,0,9,7,0,19,2:2013:True:False,True,False
Jets,10,0,17,10,0,37,Jaguars,10,3,0,0,0,13,2:2013:True:False,True,False
Texans,7,10,7,0,0,24,Dolphins,7,7,3,0,0,17,2:2013:True:False,True,False
Rams,0,0,0,7,0,7,Packers,3,6,3,7,0,19,2:2013:True:False,True,False
Seahawks,17,16,7,0,0,40,Broncos,7,0,0,3,0,10,2:2013:True:False,True,False
Giants,3,6,0,3,0,12,Colts,10,7,3,0,0,20,2:2013:True:False,True,False
Redskins,7,10,0,7,0,24,Steelers,0,6,0,7,0,13,2:2013:True:False,True,False
Lions,3,13,10,14,0,40,Patriots,0,3,0,6,0,9,3:2013:True:False,True,False
Ravens,7,0,10,10,0,27,Panthers,7,17,10,0,0,34,3:2013:True:False,True,False
Packers,3,0,7,0,0,10,Seahawks,3,0,7,7,0,17,3:2013:True:False,True,False
Raiders,0,3,17,6,0,26,Bears,17,10,0,7,0,34,3:2013:True:False,True,False
Redskins,10,10,3,7,0,30,Bills,7,0,0,0,0,7,3:2013:True:False,True,False
Colts,3,7,10,7,0,27,Browns,0,0,3,3,0,6,3:2013:True:False,True,False
Giants,7,3,3,8,0,21,Jets,7,0,7,7,3,24,3:2013:True:False,True,False
Dolphins,3,10,0,3,0,16,Buccaneers,7,3,0,7,0,17,3:2013:True:False,True,False
Steelers,10,0,7,3,0,20,Chiefs,0,10,7,3,6,26,3:2013:True:False,True,False
Jaguars,7,10,7,0,0,24,Eagles,0,16,0,15,0,31,3:2013:True:False,True,False
Titans,0,13,7,7,0,27,Falcons,6,0,10,0,0,16,3:2013:True:False,True,False
Broncos,7,3,7,10,0,27,Rams,7,13,0,6,0,26,3:2013:True:False,True,False
Cowboys,0,14,7,3,0,24,Bengals,7,0,3,8,0,18,3:2013:True:False,True,False
Cardinals,0,0,7,0,0,7,Chargers,7,7,10,0,0,24,3:2013:True:False,True,False
Texans,7,9,7,0,0,23,Saints,0,17,7,7,0,31,3:2013:True:False,True,False
49ers,10,10,0,14,0,34,Vikings,0,7,7,0,0,14,3:2013:True:False,True,False
Broncos,0,14,21,14,0,49,Ravens,7,10,0,10,0,27,1:2013:False:False,False,False
Browns,0,7,3,0,0,10,Dolphins,3,3,7,10,0,23,1:2013:False:False,False,False
Lions,3,10,14,7,0,34,Vikings,7,7,10,0,0,24,1:2013:False:False,False,False
Colts,7,7,0,7,0,21,Raiders,0,7,3,7,0,17,1:2013:False:False,False,False
Jaguars,2,0,0,0,0,2,Chiefs,14,7,0,7,0,28,1:2013:False:False,False,False
Jets,2,10,0,6,0,18,Buccaneers,7,7,0,3,0,17,1:2013:False:False,False,False
Saints,0,13,7,3,0,23,Falcons,10,0,7,0,0,17,1:2013:False:False,False,False
Steelers,2,0,0,7,0,9,Titans,0,7,3,6,0,16,1:2013:False:False,False,False
Bears,7,3,7,7,0,24,Bengals,7,7,7,0,0,21,1:2013:False:False,False,False
Panthers,0,7,0,0,0,7,Seahawks,0,3,3,6,0,12,1:2013:False:False,False,False
Bills,0,14,7,0,0,21,Patriots,10,7,0,6,0,23,1:2013:False:False,False,False
49ers,7,7,7,13,0,34,Packers,7,7,7,7,0,28,1:2013:False:False,False,False
Rams,0,10,3,14,0,27,Cardinals,0,10,14,0,0,24,1:2013:False:False,False,False
Cowboys,3,10,14,9,0,36,Giants,3,7,7,14,0,31,1:2013:False:False,False,False
Redskins,7,0,7,13,0,27,Eagles,12,14,7,0,0,33,1:2013:False:False,False,False
Chargers,7,14,7,0,0,28,Texans,7,0,7,17,0,31,1:2013:False:False,False,False
Patriots,10,3,0,0,0,13,Jets,3,0,7,0,0,10,2:2013:False:False,False,False
Falcons,14,10,0,7,0,31,Rams,0,3,7,14,0,24,2:2013:False:False,False,False
Eagles,3,7,10,10,0,30,Chargers,3,10,7,13,0,33,2:2013:False:False,False,False
Chiefs,7,0,7,3,0,17,Cowboys,10,0,3,3,0,16,2:2013:False:False,False,False
Colts,3,14,3,0,0,20,Dolphins,14,3,7,0,0,24,2:2013:False:False,False,False
Texans,7,0,7,10,6,30,Titans,7,3,0,14,0,24,2:2013:False:False,False,False
Packers,10,14,14,0,0,38,Redskins,0,0,7,13,0,20,2:2013:False:False,False,False
Ravens,0,0,7,7,0,14,Browns,3,3,0,0,0,6,2:2013:False:False,False,False
Bills,0,3,11,10,0,24,Panthers,0,7,7,9,0,23,2:2013:False:False,False,False
Bears,14,10,0,7,0,31,Vikings,7,14,3,6,0,30,2:2013:False:False,False,False
Buccaneers,7,0,0,7,0,14,Saints,10,0,3,3,0,16,2:2013:False:False,False,False
Cardinals,0,10,6,9,0,25,Lions,0,14,7,0,0,21,2:2013:False:False,False,False
Raiders,7,3,3,6,0,19,Jaguars,0,3,0,6,0,9,2:2013:False:False,False,False
Giants,3,6,7,7,0,23,Broncos,0,10,14,17,0,41,2:2013:False:False,False,False
Seahawks,0,5,7,17,0,29,49ers,0,0,3,0,0,3,2:2013:False:False,False,False
Bengals,7,3,7,3,0,20,Steelers,3,7,0,0,0,10,2:2013:False:False,False,False
Eagles,6,0,3,7,0,16,Chiefs,10,6,0,10,0,26,3:2013:False:False,False,False
Ravens,0,17,7,6,0,30,Texans,3,6,0,0,0,9,3:2013:False:False,False,False
Panthers,7,10,14,7,0,38,Giants,0,0,0,0,0,0,3:2013:False:False,False,False
Redskins,7,7,3,3,0,20,Lions,7,10,0,10,0,27,3:2013:False:False,False,False
Titans,0,10,0,10,0,20,Chargers,7,3,7,0,0,17,3:2013:False:False,False,False
Saints,7,7,3,14,0,31,Cardinals,7,0,0,0,0,7,3:2013:False:False,False,False
Patriots,0,17,3,3,0,23,Buccaneers,3,0,0,0,0,3,3:2013:False:False,False,False
Bengals,14,0,7,13,0,34,Packers,0,16,14,0,0,30,3:2013:False:False,False,False
Cowboys,10,7,7,7,0,31,Rams,0,0,7,0,0,7,3:2013:False:False,False,False
Vikings,7,10,7,3,0,27,Browns,7,17,0,7,0,31,3:2013:False:False,False,False
Dolphins,0,10,10,7,0,27,Falcons,7,6,7,3,0,23,3:2013:False:False,False,False
Jets,7,10,3,7,0,27,Bills,0,6,6,8,0,20,3:2013:False:False,False,False
49ers,7,0,0,0,0,7,Colts,7,3,3,14,0,27,3:2013:False:False,False,False
Seahawks,7,17,14,7,0,45,Jaguars,0,0,10,7,0,17,3:2013:False:False,False,False
Steelers,0,10,10,3,0,23,Bears,17,7,3,13,0,40,3:2013:False:False,False,False
Broncos,10,17,3,7,0,37,Raiders,0,7,7,7,0,21,3:2013:False:False,False,False
Rams,3,0,0,8,0,11,49ers,0,14,7,14,0,35,4:2013:False:False,False,False
Bills,6,14,3,0,0,23,Ravens,0,7,7,6,0,20,4:2013:False:False,False,False
Buccaneers,7,3,0,0,0,10,Cardinals,0,0,0,13,0,13,4:2013:False:False,False,False
Vikings,10,10,14,0,0,34,Steelers,7,3,7,10,0,27,4:2013:False:False,False,False
Chiefs,0,10,7,14,0,31,Giants,0,7,0,0,0,7,4:2013:False:False,False,False
Jaguars,3,0,0,0,0,3,Colts,0,20,14,3,0,37,4:2013:False:False,False,False
Texans,0,20,0,0,0,20,Seahawks,3,0,3,14,3,23,4:2013:False:False,False,False
Browns,7,0,3,7,0,17,Bengals,0,3,3,0,0,6,4:2013:False:False,False,False
Lions,3,27,7,3,0,40,Bears,3,10,3,16,0,32,4:2013:False:False,False,False
Titans,10,14,0,14,0,38,Jets,0,6,0,7,0,13,4:2013:False:False,False,False
Raiders,14,0,0,0,0,14,Redskins,0,10,7,7,0,24,4:2013:False:False,False,False
Broncos,14,7,21,10,0,52,Eagles,3,10,0,7,0,20,4:2013:False:False,False,False
Chargers,7,6,7,10,0,30,Cowboys,0,21,0,0,0,21,4:2013:False:False,False,False
Falcons,3,7,0,13,0,23,Patriots,0,10,3,17,0,30,4:2013:False:False,False,False
Saints,7,14,14,3,0,38,Dolphins,3,7,0,7,0,17,4:2013:False:False,False,False
Browns,0,17,7,13,0,37,Bills,10,0,14,0,0,24,5:2013:False:False,False,False
Bengals,0,3,3,7,0,13,Patriots,0,3,0,3,0,6,5:2013:False:False,False,False
Packers,3,3,10,6,0,22,Lions,0,3,0,6,0,9,5:2013:False:False,False,False
Colts,7,10,6,11,0,34,Seahawks,12,7,9,0,0,28,5:2013:False:False,False,False
Dolphins,3,10,0,10,0,23,Ravens,3,3,10,10,0,26,5:2013:False:False,False,False
Bears,0,7,3,8,0,18,Saints,6,14,3,3,0,26,5:2013:False:False,False,False
Giants,7,0,14,0,0,21,Eagles,3,16,3,14,0,36,5:2013:False:False,False,False
Titans,0,0,10,7,0,17,Chiefs,7,6,0,13,0,26,5:2013:False:False,False,False
Rams,7,17,0,10,0,34,Jaguars,10,0,3,7,0,20,5:2013:False:False,False,False
Cardinals,0,3,9,10,0,22,Panthers,3,3,0,0,0,6,5:2013:False:False,False,False
Cowboys,14,6,13,15,0,48,Broncos,7,21,10,13,0,51,5:2013:False:False,False,False
49ers,14,7,3,10,0,34,Texans,0,0,3,0,0,3,5:2013:False:False,False,False
Raiders,14,3,7,3,0,27,Chargers,0,0,3,14,0,17,5:2013:False:False,False,False
Falcons,0,7,7,14,0,28,Jets,3,14,3,10,0,30,5:2013:False:False,False,False
Bears,7,17,3,0,0,27,Giants,7,7,7,0,0,21,6:2013:False:False,False,False
Ravens,0,0,3,14,0,17,Packers,3,3,10,3,0,19,6:2013:False:False,False,False
Bills,7,3,0,14,0,24,Bengals,10,7,7,0,3,27,6:2013:False:False,False,False
Browns,0,17,0,0,0,17,Lions,7,0,7,17,0,31,6:2013:False:False,False,False
Texans,0,6,0,7,0,13,Rams,7,10,21,0,0,38,6:2013:False:False,False,False
Chiefs,0,7,7,10,0,24,Raiders,0,7,0,0,0,7,6:2013:False:False,False,False
Vikings,0,3,0,7,0,10,Panthers,7,7,14,7,0,35,6:2013:False:False,False,False
Buccaneers,3,14,0,3,0,20,Eagles,7,7,7,10,0,31,6:2013:False:False,False,False
Jets,3,3,0,0,0,6,Steelers,0,9,7,3,0,19,6:2013:False:False,False,False
Broncos,14,0,14,7,0,35,Jaguars,0,12,7,0,0,19,6:2013:False:False,False,False
Seahawks,0,7,3,10,0,20,Titans,3,7,0,3,0,13,6:2013:False:False,False,False
Patriots,3,14,3,10,0,30,Saints,7,0,10,10,0,27,6:2013:False:False,False,False
49ers,6,16,0,10,0,32,Cardinals,7,7,6,0,0,20,6:2013:False:False,False,False
Cowboys,7,7,7,10,0,31,Redskins,3,3,10,0,0,16,6:2013:False:False,False,False
Chargers,0,10,3,6,0,19,Colts,3,3,0,3,0,9,6:2013:False:False,False,False
Cardinals,0,10,3,9,0,22,Seahawks,7,10,14,3,0,34,7:2013:False:False,False,False
Falcons,7,17,0,7,0,31,Buccaneers,0,10,7,6,0,23,7:2013:False:False,False,False
Redskins,3,21,7,14,0,45,Bears,10,7,7,17,0,41,7:2013:False:False,False,False
Eagles,0,0,0,3,0,3,Cowboys,0,3,7,7,0,17,7:2013:False:False,False,False
Jets,7,3,17,0,3,30,Patriots,14,7,0,6,0,27,7:2013:False:False,False,False
Dolphins,0,14,7,0,0,21,Bills,14,3,0,6,0,23,7:2013:False:False,False,False
Jaguars,0,3,3,0,0,6,Chargers,7,7,3,7,0,24,7:2013:False:False,False,False
Panthers,7,10,10,3,0,30,Rams,2,3,7,3,0,15,7:2013:False:False,False,False
Lions,7,3,7,7,0,24,Bengals,7,7,10,3,0,27,7:2013:False:False,False,False
Titans,0,0,0,17,0,17,49ers,3,14,7,7,0,31,7:2013:False:False,False,False
Chiefs,7,7,3,0,0,17,Texans,3,7,6,0,0,16,7:2013:False:False,False,False
Steelers,7,3,3,6,0,19,Ravens,3,3,0,10,0,16,7:2013:False:False,False,False
Packers,14,3,0,14,0,31,Browns,0,3,3,7,0,13,7:2013:False:False,False,False
Colts,10,16,7,6,0,39,Broncos,7,7,3,16,0,33,7:2013:False:False,False,False
Giants,3,7,7,6,0,23,Vikings,7,0,0,0,0,7,7:2013:False:False,False,False
Buccaneers,3,3,0,7,0,13,Panthers,7,7,7,10,0,31,8:2013:False:False,False,False
Jaguars,0,3,7,0,0,10,49ers,14,14,7,7,0,42,8:2013:False:False,False,False
Chiefs,6,14,0,3,0,23,Browns,0,10,7,0,0,17,8:2013:False:False,False,False
Patriots,0,3,17,7,0,27,Dolphins,7,10,0,0,0,17,8:2013:False:False,False,False
Saints,7,14,7,7,0,35,Bills,0,10,0,7,0,17,8:2013:False:False,False,False
Lions,7,0,0,24,0,31,Cowboys,0,10,3,17,0,30,8:2013:False:False,False,False
Eagles,0,0,0,7,0,7,Giants,6,6,0,3,0,15,8:2013:False:False,False,False
Raiders,14,7,0,0,0,21,Steelers,0,3,0,15,0,18,8:2013:False:False,False,False
Bengals,14,14,14,7,0,49,Jets,0,6,3,0,0,9,8:2013:False:False,False,False
Cardinals,0,21,3,3,0,27,Falcons,3,3,0,7,0,13,8:2013:False:False,False,False
Broncos,7,0,7,31,0,45,Redskins,0,7,14,0,0,21,8:2013:False:False,False,False
Vikings,7,10,0,14,0,31,Packers,7,17,7,13,0,44,8:2013:False:False,False,False
Rams,3,0,3,3,0,9,Seahawks,0,7,7,0,0,14,8:2013:False:False,False,False
Dolphins,0,10,7,3,2,22,Bengals,0,3,7,10,0,20,9:2013:False:False,False,False
Panthers,7,7,3,17,0,34,Falcons,0,10,0,0,0,10,9:2013:False:False,False,False
Cowboys,3,3,14,7,0,27,Vikings,3,7,7,6,0,23,9:2013:False:False,False,False
Jets,3,17,3,3,0,26,Saints,7,7,3,3,0,20,9:2013:False:False,False,False
Rams,0,7,7,7,0,21,Titans,7,0,7,14,0,28,9:2013:False:False,False,False
Bills,7,3,3,0,0,13,Chiefs,0,3,10,10,0,23,9:2013:False:False,False,False
Redskins,0,7,7,10,6,30,Chargers,0,14,0,10,0,24,9:2013:False:False,False,False
Raiders,3,10,0,7,0,20,Eagles,7,21,21,0,0,49,9:2013:False:False,False,False
Seahawks,0,7,7,10,3,27,Buccaneers,0,21,3,0,0,24,9:2013:False:False,False,False
Browns,7,7,7,3,0,24,Ravens,3,7,0,8,0,18,9:2013:False:False,False,False
Patriots,7,17,3,28,0,55,Steelers,0,10,14,7,0,31,9:2013:False:False,False,False
Texans,14,7,3,0,0,24,Colts,0,3,9,15,0,27,9:2013:False:False,False,False
Packers,10,0,10,0,0,20,Bears,7,10,7,3,0,27,9:2013:False:False,False,False
